a=ampere
a.d.=atas dasar
a.d.c.=aide-de-camp
a.h.=anno hejirae
a.i.=ad interim
a.l.=antara lain
a.m.=ante meridiem
a.m.=sebelum tengah hari
a.m.v.b.=algemene maatregel van bestuur
a.n.=atas nama
a.n.b.=atas nama beliau
a.p.=atas perintah
a.s.=alaihi salam
a/o=account officer
aa=asia afrika
aai=asosiasi advokat indonesia
aal=akademi angkatan laut
aamii=asosiasi aparel manufaktur indonesia
aao=assistant account officer
aap=australian associated press
ab=angkatan bersenjata
abaei=asosiasi biro administrasi efek indonesia
abg=anak baru ged
abi=asosiasi bakery indonesia
abki=asosiasi bank kustodian indonesia
abmi=asosiasi budidaya mutiara indonesia
abn=anggaran belanja negara
abnon=abang dan none
abp=agence burundaise de presse
abri=angkatan bersenjata republik indonesia
abrip=ajun brigadir polisi
abripda=ajun brigadir polisi ii
abriptu=ajun brigadir polisi i
abs=asal bapak senang
abt=anggaran belanja tahunan
abu=asian broadcasting union
ac=air conditioner
acc=accord
acd=anti celana dalam
acdc=biseksual
aci=aku cinta indonesia
acpi=advanced configuration and power interface
acr=advanced communication riser
acted=agency for technical cooperational and development
ad=angkatan darat
adb=asian development bank
adc=analog to digital converter
adia=akademi dinas ilmu agama
adl=adalah
adm.=administrasi
adpcm=adaptive differential pulse-code modulation
adpel=administrasi pelabuhan
adpi=asosiasi dana pensiun indonesia
adri=angkatan darat republik indonesia
adsl=asymmetric digital subscriber line
aei=asosiasi emiten indonesia
aeihi=asosiasi eksportir ikan hias indonesia
aeki=asosiasi eksportir kopi indonesia
af=audio frequency
afa=asean federation of accountants
afi=asosiasi franchise indonesia
afp=agence france de presse
ag=asian games
agi=asosiasi gula indonesia
agp=agence gabonaise de presse
agri=asosiasi gula rafinasi indonesia
agus=agak gundul sedikit
aice=association of indonesian coffee exporters
aicesscc=association of indonesia-china economic, social and cultural cooperation
aids=acquired immunodeficiency syndrome
aifta=asosiasi industri formalin dan thermosetting adhesive
aigi=asosiasi industri glukosa indonesia
aimmi=asosiasi industri minyak makan indonesia
aip=akademi ilmu pelayaran
aipda=ajun inspektur ii
aipi=asosiasi ilmu politik indonesia
aipo=asian inter-parliamentary organization
aips=association internale de la presse sportive
aiptu=ajun inspektur i
ais=akademi ilmu statistika
aisi=asosiasi independen surveyor indonesia
ajb=akta jual beli
aji=aliansi jurnalis independen
ak.=akuntan
ak=angka kredit
akabri=akademi bersenjata republic indonesia
akad=angkatan kerja antardaerah
akaindo=asosiasi kontraktor air indonesia
akbp=ajun komisaris besar polisi
akdai=asosiasi kimia dasar anorganik indonesia
akhi=asosiasi konsultan hukum indonesia
aki=asosiasi kontraktor indonesia
akindo=akademi komunikasi indonesia
akip=akuntabilitas kinerja instansi pemerintah
akli=asosiasi kontraktor listrik indonesia
akp=ajun komisaris polisi
akpi=asosiasi kurator dan pengurus indonesia
akpol=akademi polisi
akt.=akuntan
akubbi=asosiasi industri ketel uap dan bejana bertekanan indonesia
al=angkatan laut
ali=asosiasi logistik indonesia
aljasa=asal jadi saja
almi=asosiasi logam mulia indonesia
alri=angkatan laut republik indonesia
alu=arithmetic logic unit
alutsista=alat utama sistem pertahanan
am=active matrix
ama=asosiasi manajemen indonesia
aman=aliansi masyarakat adat nusantara
amd=abri masuk desa
amdal=analisis mengenai dampak lingkungan
ami=akademi musik indonesia
amii=angkatan muda islam indonesia
amir=amitamit
amm=asean ministerial meeting
amn=akademi militer nasional
amp=agence madagascar de presse
ampera=amanat penderitaan rakyat
ampi=angkatan muda pembaharuan indonesia
ampuh=asosiasi muslim pengusaha umrah dan haji
amr=audio modem riser
ams=angkatan muda siliwangi
amss=association of muslim social sciences
amt=akademi militer tangerang
ana=2 athens news agency
anc=african national congress
andal=analisis dampak lingkungan
anex=asean news exchange
anfe=asian network for free election
angkot=angkutan kota
angmor=angkutan bermtor
angop=agencia angolana de prensa
anm.=anumerta
anp=algemen nederlands persbureu
anpi=asosiasi niaga pupuk indonesia
ansi=american national standards institute
ant.=antara
anteve=andalas nusantara televisi
aohi=asosiasi obat hewan indonesia
ap=associated press
ap3i=asosiasi pengelola pusat perbelanjaan indonesia
apa=austria press agentur
apbd=anggaran pendapatan dan belanja daerah
apbi=asosiasi perusahaan ban indonesia
apblsi=asosiasi pemotongan baja lembaran seluruh indonesia
apbmi=asosiasi perusahaan bongkar muat indonesia
apbn=anggaran pendapatan dan belanja negara
apbti=asosiasi produsen benang tekstur indonesia
apci=asosiasi pengusaha coldstorage indonesia
apdesi=asosiasi perangkat desa seluruh indonesia
apdn=akademi pemerintahan dalam negeri
apec=asia pacific economic cooperation
apecc=asia pacific exhibition and convention council
apegti=asosiasi penyalur gula dan tebu indonesia
apei=asosiasi perusahaan efek indonesia
apepi=asosiasi pengusaha emas dan permata indonesia
apfi=asosiasi pengusaha furnitur indonesia
apfindo=asosiasi produsen daging dan feedlot indonesia
apgai=asosiasi pemasok garmen dan aksesoris indonesia
apgi=asosiasi produsen gas-gas industri indonesia
aphi=asosiasi pengusaha hutan indonesia
apht=akta pembebanan hak tanggungan
api=akademi penerbangan indonesia
apiei=asosiasi perusahaan industri elektronik dan alat-alat listrik rumah tangga indonesia
apindo=asosiasi pengusaha indonesia
apitindo=asosiasi perusahaan inspeksi teknik indonesia
apjati=asosiasi perusahaan jasa tenaga kerja indonesia
apjii=asosiasi penyelenggara jasa internet indonesia
apk=alat peraga kampanye
apkabel=asosiasi pabrik kabel listrik indonesia
apkasi=asosiasi pemerintah kabupaten seluruh indonesia
apki=asosiasi pulp dan kertas indonesia
apkindo=asosiasi panel kayu indonesia
apklindo=asosiasi perusahaan klining indonesia
apkomindo=asosiasi pengusaha komputer indonesia
apli=asosiasi penjualan langsung indonesia
apm=advanced power management
apmi=asosiasi pengeboran minyak dan gas bumi indonesia
apnatel=asosiasi perusahaan nasional telekomunikasi
apodeti=associacao popular democratica timorense
app=akademi pimpinan perusahaan
appi=asosiasi perusahaan pembiayaan indonesia
appli=asosiasi produsen peralatan listrik indonesia
appm=asosiasi praktisi periklanan media
appmi=asosiasi perancang pengusaha mode indonesia
appp=asosiasi produsen pipa listrik
apr=amanat penderitaan rakyat
apra=angkutan perang ratu adil
apri=angkatan perang republik indonesia
aprindo=asosiasi pengusaha ritel indonesia
apris=angkatan perang ri serikat
aprisindo=asosiasi persepatuan indonesia
aprogakob=asosiasi produsen garam konsumsi beryodium
aps=alat peraga sosialisasi
aps=algerie presse service
apscsi=asosiasi produsen sodium cyclamate dan sacharine indonesia
apu=ahli peneliti utama
apva=asosiasi perdagangan valuta asing
apwkomitel=asosiasi pengusaha warnet komunitas telematika
arhanud=artileri pertahanan udara
arindo=asosiasi rotan indonesia
armed=artileri medan
arna=arab revolutionary news agency
arpindo=asosiasi penyelenggara radio panggil indonesia
art.=artikel
art=anggaran rumah tangga
arumba=alunan rumpun bambu
as=amerika serikat
asaghi=asosiasi agribisnis hortikultura indonesia
asbindo=asosiasi bunga indonesia
asbun=asal bunyi
asean=association of southeast asian nations
aseanta=asean tourism association
aseantta=asean tourism and travel association
asem=aseaneurope meeting
asephi=asosiasi eksportir dan produsen handicraft indonesia
asi=air susu ibu
asic=application specific integrated circuit
asirevi=assosiasi industri rekaman video indonesia
asiri=asosiasi lndustri rekaman indonesia
asita=association of the indonesian tours and travel agencies
askes=asuransi kesehatan
askeskin=asuransi kesehatan keluarga miskin
askindo=asosiasi kakao indonesia
askitel=asosiasi kliring trafik telekomunikasi indonesia
askrindo=asuransi kredit indonesia
asku=asisten keuangan
aslog=asisten logistik
asm=akademi sekretari manajemen
asmindo=asosiasi pengusaha mebel indonesia
asops=asisten operasi
asosai=asian organization of supreme audit institutions
aspadin=asosiasi perusahaan air minum dalam kemasan indonesia
aspal=asli tetapi palsu
aspek=asosiasi serikat pekerja
aspep=asosiasi pengerjaan logam dan permesinan
asperindo=asosiasi perusahaan jasa pengiriman ekspres indonesia
aspetex=asosiasi pedagang tekstil
aspiluki=asosiasi piranti lunak telematika indonesia
aspri=asisten pribadi
aspringta=asosiasi perajin bunga kering
asrena=asisten perencanaan
asrenum=asisten rencana umum
asri=akademi seni rupa indonesia
astek=asosiasi sosial tenaga kerja
asteng=asia tenggara
aster=asisten teritorial
asti=akademi seni tari indonesia
astrada=asisten sutradara
astul=asal tulis
aswo=asli jowo
at=advanced technology
ata=air transport association
atal=atase angkatan laut
atbm=alat tenun bukan mesin
atc=air traffic control
atdikbud=atase pendidikan dan kebudayaan
atf=asean tourism forum
athan=atase pertahanan
atk=alat tulis kantor
atm=anjungan tunai mandiri
atm=atmosfer
atmil=atase militer
atni=akademi teater nasional indonesia
atp=automatic teller person
atpm=agen tunggal pemegang merk
atra=advanced technology regional aircraft
atu=atase udara
atud=atase udara
atvli=asosiasi televisi lokal indonesia
atvsi=asosiasi televisi swasta indonesia
atx=advenced technology extended
au=angkatan udara
aumi=asosiasi usaha menengah indonesia
aup=akademi usaha perikanan
auri=angkatan udara republik indonesia
ava=audio visual aids
avdp=avoirdupois
avi=agence vietnamienne d'information
avtur=aviation turbo
ay.=ayat
azap=agence zaire de presse
b.a.=bachelor of arts
b.b.a.=bachelor of business administration
b.ch.e.=bachelor of chemical engineering
b.ch.e=bachelor of chemical engineering
b.d.=berat jenis
b.j.=bacharuddin jusuf
b.sc.=bachelor of science
b2=bahan berbahaya
b3=bahan berbahaya dan beracun
baak=biro administrasi akademis kemahasiswaaan
bab=buang air besar
babel=bangka belitung
babinhumnas=badan pembinaan hukum nasional
babinkar=badan pembinaan karyawan
babinkum=badan pembinaan hukum
babinkumnas=badan pembinaan hukum nasional
bahumas=badan musyawarah pengusaha swasta
bais=badan intelijen strategis
bak=biro administrasi keuangan
baket=bahan keterangan
bakin=badan koordinasi intelijen negara
bakn=badan administrasi kepegawaian negara
bakolak=badan koordinasi pelaksanaan
bakom-pkb=badan komunikasi penghayatan kesatuan bangsa
bakopda=badan koordinasi pembangungan daerah
bakoptranas=badan koordinasi penyelenggaraan transmigrasi nasional
bakorkamla=badan koordinasi keamanan laut
bakorlak=badan koordinasi pelaksana penanganan bencana
bakorlantik=badan koordinasi masalah kenakalan remaja penyalahgunaan narkotika
bakornas=badan koordinasi nasional
bakorpakem=badan koodinasi pengawas aliran kepercayaan masyarakat
bakorstanas=badan koordinasi stabilitas nasional
bakorstanasda=badan koordinasi stabilitas nasional daerah
bakosurtanal=badan koordinasi survei dan pemetaan nasional
baleg=badan legislasi
balita=bawah lima tahun
balitbang=badan penelitian dan pengembangan
balmera=belawan, medan, utara
balon=bakal calon
balon=bakal calon
bamudes=badan musyawarah desa
bamus=badan musyawarah
ban=badan akreditasi nasional
bandara=bandar udara
bandes=bantuan desa
bangdes=pembangunan desa
bangtek=pengembangan teknik
bankom=bantuan komunikasi
banmin=bantuan administrasi
banpol=bantuan polisi
banpres=bantuan presiden
banpro=bandung promotion group
banpur=bantuan tempur
bansarkas=bantuan sarana kesehatan
banser=barisan ansor serbaguna
bap=berita acara pemeriksaan
bapas=balai pemasyarakatan
bapebti=badan pengawas bursa komoditi
bapedal=badan pengendalian dampak lingkungan
bapedalda=badan pengendalian dampak lingkungan daerah
bapeka=badan pemeriksa keuangan
bapekan=badan pengawas kegiatan aparatur negara
bapeksta=badan pelayanan kemudahan ekspor dan pengolahan data keuangan
bapepam=badan pengawasan pasar modal
baperki=badan permusyawarahan kewarganegaraan indonesia
bapfida=badan pembina perfilman daerah
bapindo=bank pembangunan indonesia
bappebti=badan pengawas perdagangan berjangka komoditi
bappeda=badan perencanaan dan pembangunan daerah
bappenas=badan perencanaan pembangunan nasional
basarnas=badan search and rescue nasional
bat=british american tobacco
batan=badan tenaga atom nasional
batita=bawah tiga tahun
batola=barito kuala
bau=biro administrasi umum
bawasda=badan pengawas daerah
bawaslu=badan pengawas pemilu
bazis=badan amal, zakat, infak, dan sedekah
bb=binnenlands bestuur
bbc=british broadcasting corporation
bbd=bank bumi daya
bbg=bahan bakar gas
bbm=bahan bakar minyak
bbn=bea balik nama
bbnkb=bea balik nama kendaraan bermotor
bbrvbd=balai besar rehabilitasi vokasional bina daksa
bbs=bangladesh sangbad sangstha
bc.a.k.=baccalaureat administrasi kepegawaian
bc.ac.p.=baccalaureat akademi pos
bc.hk.=baccalaureat hukum
bc.i.=baccalaureat imigrasi
bc.kwn.=baccalaureat keuangan negara
bc.t.t.=baccalaureat telepon dan telegraf
bc=before christ
bca=bank central asia
bcg=bacillus calmette-guerin
bct=breast conserving treatment
bd=barat daya
bdb=bebas dari bea
bdn=bank dagang negara
bdp=bank dalam penyehatan
begor=bebek goreng
bei=bursa efek indonesia
bej=bursa efek jakarta
belmera=belawanmedantanjungmorawa
bemo=becak bermotor
bep=break-even point
bepeket=belawanpenangphuket
berdikari=berdiri di atas kaki sendiri
bermis=beton ringan pamis
bernama=berita nasional malaysia
beta=benda terbang aneh
betacipok=bekasitangerangcibinongdepok
bfn=badan futsal nasional
bga=ball grid array
bh=bustehouder
bharada=bhayangkara dua
bharaka=bhayangkara kepala
bharatu=bhayangkara satu
bharuda=bhayangkara utama dua
bharumud=bhayangkara utama muda
bharuta=bhayangkara utama satu
bharutu=bhayangkara utama satu
bhmn=badan hukum milik negara
bi=bank indonesia
bia=badan intelijen abri
bida=batam industrial development authority
bidsus=bidang khusus
bii=bank internasional indonesia
bikn=badan informasi dan komunikasi nasional
bima=biru malam
bimas=bimbingan masyarakat
bimbel=bimbingan belajar
bimbuluh=bimbingan dan penyuluhan
bimp-eaga=brunei, indonesia, malaysia and the philippines - east asian growth area
bin=badan intelejen negara
bintal=bimbingan mental
bios=basic input output system
biotrop=biologi tropikal
bipi=balai informasi dan promosi industri
bipik=bimbingan dan pengembangan industri kecil
bis=bank for international settlement
bjj=belajar jarak jauh
bk=bimbingan dan konseling
bkia=balai kesehatan ibu dan anak
bkkbn=badan koordinasi keluarga berencana nasional
bkkks=badan koordinasi kegiatan kesejahteraan sosial
bkll=badan koordinasi lingkungan lingkungan
bkln=biro kerja sama luar negeri
bkmg=badan meteorologi, klimatologi dan geofisika
bkn=badan kesejahteraan nasional
bkn=bukan
bkow=badan kerja sama organisasi wanita
bkpm=badan koordinasi penanaman modal
bkpmd=badan koordinasi penanaman modal daerah
bkpn=badan kebijaksanaan perumahan nasional
bkr=barisan keamanan rakyat
bksda=balai konservasi sumber daya alam
bksp=badan kerja sama pembangunan
bktn=badan koperasi tani dan nelayan
bl=bill of lading
blbi=badan likuidasi bank indonesia
blhi=bina lingkungan hidup indonesia
bli=badan liga indonesia
blk=balai latihan kerja
blki=balai latihan kerja industri
blkln=balai latihan kerja luar negeri
blm=belum
bls=balas
blu=badan layanan umum
bm=bahasa melayu
bmd=badan musyawarah desa
bmg=badan meteorologi dan geofisika
bmhd=bunga yang masih harus dibayar
bmi=bank muamalat indonesia
bmph=barel minyak per hari
bmpk=batas maksimum pemberian kredit
bn=berita negara
bni=bank negara indonesia
bnn=badan narkotika nasional
bnp2tki=badan nasional penempatan dan perlindungan tenaga kerja indonesia
bo=body odour
boe=barrel oil equivalent
bokar=bahan olah karet
bopd=barrels of oil per day
bopunjur=bogorpuncakcianjur
bos=bantuan operasional sekolah
bot=bangun, operasikan, transfer
botabek=bogortangerangbekasi
bp=balai pustaka
bp2ls=badan pelaksana penanggulangan lumpur sidoarjo
bp2sam=badan pelaksana penanggulangan sarana air minum
bp3=badan pembantu penyelenggara pendidikan
bp3k=badan penelitian pengembanan pendidikan dan kebudayaan
bp4=badan penasihat perkawinan dan penyelesaian perceraian
bp7=badan pembina pendidikan pelaksanaan pedoman penghayatan dan pengamalan pancasila
bpd=bank pembangunan daerah
bpen=badan pengembangan ekspor nasional
bpfkppa=badan pekerja forum komunikasi pembinaan dan pengembangan anak
bpg=balai pendidikan guru
bph migas=badan pengatur kegiatan hilir minyak dan gas bumi
bph=badan pemerintah harian
bphh=balai penyelidikan hasil hutan
bphn=badan pembinaan hukum nasional
bphtb=bea perolehan hak atas tanah dan bangunan
bpi=bursa paralel indonesia
bpih=biaya penyelenggaraan ibadah haji
bpis=badan pengelola industri strategis
bpk=badan pemeriksa keuangan
bpkb=buku pemilik kendaraan bermotor
bpkh=badan pembelaan dan konsultasi hukum 
bpkks=badan pembinaan kegiatan kesejahteraan sosial
bpkn=badan perlindungan konsumen nasional
bpkp=badan pengawas keuangan dan pembangunan
bpkpa=badan pekerja konsorsium pembaruan agraria
bpkpn=badan pemeriksa kekayaan pejabat negara
bpm=badan pemberdayaan masyarakat
bpmb=balai pengawasan mutu barang
bpmd=balai pendidikan masyarakat desa
bpn=badan pertanahan nasional
bpom=badan pengawasan obat dan makanan
bpp teknologi=badan pengkajian dan penerapan teknologi
bpp=badan pimpinan pusat
bppc=badan penyangga dan pemasaran cengkih
bpphh=balai penelitian pengembangan hasil hutan
bppi=badan promosi pariwisata indonesia
bppk=badan pertimbangan perintis kemerdekaan
bppka=badan pembinaan pengusahaan kontraktor asing
bppn=badan penyehatan perbankan nasional
bppt=badan pengkajian dan penerapan teknologi
bpr=bank perkreditan rakyat
bps=badan pusat statistik
bpsk=badan penyelesaian sengketa konsumen
bptp=balai penelitian tanaman pangan
bpupki=badan penyelidik usaha-usaha persiapan kemerdekaan indonesia
bput=badan pertimbangan urusan tanah
brd=bank rakyat desa
bri=bank rakyat indonesia
brief=business review indonesia forum
brigif=brigade infanteri
brigjen=brigadir jenderal
brigjenpol=brigadir jenderal polisi
brigpol=brigadir polisi
brimob=brigade mobil
bripda=brigadir polisi ii
bripka=brigadir polisi kepala
briptu=brigadir polisi i
brn=badan rahasia nasional
brp=berapa
brr=badan rekonstruksi dan rehabilitasi
brti=badan regulasi telekomunikasi indonesia
bs=bisa
bsf=badan sensor film
bsk=besok
bta=bulgarska telegrafischeka agentzia
btai=badan tenaga atom internasional
btn=bank tabungan negara
btpn=bank tabungan pensiun negara
bts=base transmission station
btu=british thermal unit
bugil=bule gila
bukopin=bank umum koperasi indonesia
bulog=badan urusan logistik
bumd=badan usaha milik daerah
bumn=badan usaha milik negara
buras=bukan ras
burt=badan urusan rumah tangga nasional
buser=buru sergap
but=bentuk usaha tetap
butsi=badan urusan tenaga kerja sukarela indonesia
buud=badan usaha unit desa
bw=burgerlijk wetboek
c.c.=carbon copy
c.o.=commanding officer
c.q.=casu quo
c=celcius
ca=circa
caba=calon bintara
cadek=catur dharma eka karma
calhaj=calon haji
cama=calon mahasiswa
cami=calon mahasiswi
can=cyprus news agency
cana=caribbian news agency
capa=calon perwira
capeg=calon pegawai
cas=column address signal
cawu=caturwulan
cbo=community base organization
cbsa=cara belajar siswa aktif
cc=corps consulaire
ccd=charge coupled device
cci asean=asean chamber of commerce and industry 
cctv=closed circuit television
cd=corps diplomatique
cdma=code division multiple acces
cdr=compact disk recorder
cd-rom=compact disk-read only memory
cdrw=compact disk re-writer
cekal=cegah tangkal
ceo=chief executive officer
cerber=cerita bersambung
cerbung=cerita bersambung
cergam=cerita bergambar
cerpen=cerita pendek
cesda=center for the study of development and democracy
cf.=confer
cf=confer
cgi=consultative group on indonesia
cia=central intelligence agency
cides=center for information and development studies
cifor=center for international forestry research
ckp=cukup
cnppasea=commission on national parks and protected areas for south east asia
cnrt=conselho nacional da resistencia timorense
co.=company
co=community organizer
cod=cash on delivery
coklit=pencocokan dan penelitian
cominac=conference of ministers of information of non-alignment countries
cp=candlepower
cp=cerebral palsy
cpe=central planned economics
cpis=center for policy and implementation studies
cpl=civil pilot licence
cpm=corps polisi militer
cpns=calon pegawai negeri sipil
cpo=crude palm oil
cpu=central processing unit
crc=canadian red cross
crp=community recovery program
crt=cathode-ray tube
csis=center for strategic and international studies
cso=civil society organization
cst=cangkok sumsum tulang
csw=centrale stichting wederopbouw
ctk=czekolavenska tiskora kancelar
curanmor=pencurian kendaraan bermotor
curas=pencurian dengan kekerasan
curcol=curahan hati colongan
curhat=curahan hati
cv=2 curriculum vitae
cws=church world services
d.a.=dengan alamat
d.l.=dinas luar
d.sc.=doctor of science
d1=diploma satu
d-1=diploma satu
d2=diploma dua
d-2=diploma dua
d3=diploma tiga
d-3=diploma tiga
d4=diploma empat
d-4=diploma empat
da=daerah
da=datadata agunan
dac=digital-to-analog converter
dacs=digital acces and cross-connect system
dae=digital audio extraction
dai=dewan asuransi indonesia
damri=djawatan angkutan motor republik indonesia
dandim=komandan distrik militer
danramil=komandan rayon militer
danrem=komandan resort militer
dansek=komandan sektor
danton=komandan peleton
danwil=komandan wilayah
danyon=komandan batalion
dapil=daerah pemilihan
das=daerah aliran sungai
daswati i=daerah swatantra tingkat i
dati i=daerah tingkat i
dba=doctor of business administration
dbd=demam berdarah dengue
dc=irect current
dcs=daftar caleg sementara
dct=daftar caleg tetap
ddc=display data channel
ddii=dewan dakwah islamiyah indonesia
ddktd=dengan demikian kesalahan telah diperbaiki
ddr=double data rate
ddr-sdram=double data rate-synchronous dynamics random acces memory
dds=doctor of dental surgery
ddt=dichloro-diphenyl-trichloro-ethane
dec=digital equipment corporation
dekon=deklarasi ekonomi
dekopin=dewan koperasi indonesia
dekranas=dewan kerajinan nasional
den=dewan ekonomi nasional
denintel=detasemen intel
denma=detasemen markas
dep p&k=departemen pendidikan dan kebudayaan
depag=departemen agama
depanri=dewan penerbangan dan antariksa nasional republik nasional
deparpostel=departemen pariwisata, pos, dan telekomunikasi
depbudpar=departemen kebudayaan dan pariwisata
depdagri=departemen dalam negeri
depdiknas=departemen pendidikan nasional
deperdag=departemen perdagangan
deperhub=departemen perhubungan
deperind=departemen perindustrian
deperindag=departemen perindustrian dan perdagangan
depertamben=departemen pertambangan dan energi
depertan=departemen pertanian
depertanhut=departemen pertanian dan kehutanan
dephankam=departemen pertahanan dan keamanan
dephub=departemen perhubungan
dephut=departemen kehutanan
depkeh ham=departemen kehakiman dan hak asasi manusia
depkeh=departemen kehakiman
depkehut=departemen kehutanan
depkes=departemen kesehatan
depkeu=departemen keuangan
depkimpraswil=departemen permukiman dan prasarana wilayah
depkominfo=departemen komunikasi dan informatika
depkumdang=departemen hukum dan perundang-undangan
depkumham=departemen hukum dan hak asasi manusia
deplu=departemen luar negeri
depnaker=departemen tenaga kerja
depnakertrans=departemen tenaga kerja dan transmigrasi
depparbud=departemen pariwisata dan kebudayaan
deppen=departemen penerangan
deppostel=departemen pos, dan telekomunikasi
depsos=departemen sosial
deptamben=departemen pertambangan dan energi
deptan=departemen pertanian
deptrans=departemen transmigrasi
dewan hankamnas=dewan pertahanan keamanan nasional
dfk=datadata fasilitas kredit
dfn=dewan film nasional
dg=dengan
dgn=dengan
di=daerah istimewa
dia=daerah istimewa aceh
dik=daftar isian kegiatan
dikdasmen=pendidikan dasar dan menengah
diklat=pendidikan dan pelatihan
diklusepora=pendidikan luar sekolah, pemuda, dan olahraga
dikmenjur=pendidikan menengah kejuruan
dikmenum=pendidikan menengah umum
dikti=pendidikan tinggi
dimm=dual inline memory module
dip=daftar informasi publik
dip=daftar isian proyek
dir=direktur
dirjen=direktur jendral
dirum=direktur umum
dirut=direktur utama
dispenda=dinas pendapatan daerah
dit=direktorat
ditjen=direktorat jendral
diy=daerah istimewa yogyakarta
dk=dewan keamanan
dki jakarta=daerah khusus ibu kota jakarta
dki jaya=daerah khusus ibu kota jakarta raya
dki=daerah khusus ibu kota
dkk.=dan kawan-kawan
dkp=daftar kekayaan pribadi
dkpp=dewan kehormatan penyelenggara pemilu
dks=dewan kesenian surabaya
dl=dulu
dll.=dan lain-lain
dllaj=dinas lalu lintas dan angkutan jalan raya
dllajr=dinas lalu lintas dan angkutan jalan raya
dlm=dalam
dls=doctor of library science
dma=direct memory access
dmn=di mana
dmo=disfungsi minimal otak
dna=deoxyribose-nucleic acid
dni=daftar negatif investasi
do=drop out
docsis=data over cable systems interface specifications
dolog=depot logistik
dologda=depot logistik daerah
dom=daerah operasi militer
dot=daftar orang tercela
doz=dozen
dp3=daftar penilaian pelaksanaan pekerjaan
dpa=dewan pertimbangan agung
dpc=dewan pimpinan cabang
dpd=dewan pimpinan daerah
dpe=dewan penunjang ekspor
dpi=dots per inch
dpis=dewan pembina industri strategis
dpk=daftar pemilih khusus
dpk=dalam perhatian khusus
dpkeku=dewan pemantapan ketahanan ekonomi dan keuangan
dpn=dewan pengurus nasional
dpo=daftar pencarian orang
dpp=dewan pimpinan pusat
dpph=daftar pemilih pindahan
dpr ri=dewan perwakilan rakyat republik indonesia
dpr=dewan perwakilan rakyat
dprd i=dewan perwakilan rakyat daerah, tingkat i
dprd ii=dewan perwakilan rakyat daerah, tingkat ii
dprd=dewan perwakilan rakyat daerah
dps=daftar pemilih sementara
dpt=daftar pemilih tetap
dpt=dapat
dpt=diphteria, pertusis, tetanus
dptb=daftar pemilih tambahan
dpthp=daftar pemilih tetap hasil perbaikan
dpu=dinas pekerjaan umum
dpw=dewan pimpinan wilayah
dr.=dokter
dr.=doktor
dr.h.c=doctor honoris causa
dr.phil.=doctor of philosophy
dr.th.=doctor theologiae
dr=dana reboisasi
dra.=doktoranda
dram=dynamic random access memory
drg.=dokter gigi
drh.=dokter hewan
drn=dewan riset nasional
drs.=doktorandus
ds.=dominus
ds=dominus
dsb.=dan sebagainya
dsn=dewan standardisasi nasional
dsp=daftar skala prioritas
dspp=daftar susunan personil dan peralatan
dst.=dan seterusnya
dtd=dinas transfusi darah
dtg=datang
dtk=dinas tata kota
dtw=daerah tujuan wisata
dubes=duta besar
duk=daftar usulan kegiatan
dukcapil=kependudukan dan catatan sipil
dul katruk=gundul kayak petruk
dup=daftar usulan proyek
dvd=digital versatile disc
dvd-ram=digital versatile disc-random access memory
dwikora=dwikomando rakyat
e.g.=exempli gratia
e.z.=economische zaken
eaga=east asean growth area
eboni=eh, botak nih!
ebta=evaluasi belajar tahap akhir
ebtanas=evaluasi belajar tahap akhir nasional
ecafe=economic commission for asia and the far east
ecc=error correction code
ecg=electrocardiogram
econit=advisory group on economic industry and trade
ecosoc=economic and social council
ecp=enhanced capability port
ed.=edition
eec=european economic community
eeg=electroencephalogram
egp=emangnya gua pikirin
ejip=east jakarta industrial park
ekg=elektrokardiogram
ekonid=germanindonesian chamber of commerce and industry
ekotek=ekonomi dan teknis
eks.=eksemplar
eksim=ekspor impor
eksim=ekspor-impor
ekubang=ekonomi, keuangan, pembangunan
ekuin=ekonomi, keuangan dan industri
ela=ekstrem lainnya
elenji=liquified natural gas
els=europese lagere school
elsam=lembaga studi advokasi masyarakat
emka=ekspedisi muatan kereta api
emkl=ekspedisi muatan kapal laut
emku=ekspedisi muatan kapal udara
ena=ethiopian news agency
eo=event organizer
epic=explicitly parallel instruction computing
epo=exit permit only
epp=enhanced parallel port
epz=export processing zone
eq=emotional quotient
era=early recovery assistance
erts=earth resources telecommunication satellite
escap=economic and social commission for asia and the pacific
esd=electrostatic discharge
esdm=energi sumber daya mineral
et=eks tapol
etan=east timor alert network
etc.=et cetera
etd=estimated time of departure
eu=european union
ewsd=electronic worldwide switch digital
ext.=extension
eyd=ejaan yang disempurnakan
f=fahrenheit
fabri=fraksi abri
faks.=faksimile
falintil=forcas armadas da libertacao nacional de timor leste
fao=food and agriculture organization
fapoltan=fakultas politeknik pertanian
fasc.=fasciculus
fasi=federasi aeromodelling seluruh indonesia
fasilkom=fakultas ilmu komputer
fax=facsimile
fbi=federal bureau of investigation
fbr=forum betawi rempug
fbsi=federasi buruh seluruh indonesia
fchi=forum cendekiawan hindu indonesia
fc-pga=flip chip pin grid array
fdc=floppy disk controller
fdd=floppy disk drive
fddi=fiber distributed data interconnect
fe=fakultas ekonomi
feo=fiduciare eigendom overdracht
feram=ferroelectric random
feui=fakultas ekonomi, universitas indonesia
ff=fortissimo
ffi=festival film indonesia
fh=fakultas hukum
fib=fakultas ilmu pengetahuan budaya
fifa=federation of international football association
fifo=first in first out
fifo=first in, first out
finek=finansialekonomi
fip=fakultas ilmu pendidikan
fipia=fakultas ilmu pasti dan ilmu alam
fisip=fakultas ilmu sosial dan ilmu politik
fk=fakultas kedokteran
fkg=fakultas kedokteran gigi
fkh=fakultas kedokteran hewan
fki=forum kerja indonesia
fkip=fakultas keguruan dan ilmu pendidikan
fkkp=forum komunikasi kelompok pengimbang
fkm=front kedaulatan maluku
fkmui=fakultas kesehatan masyarakat, universitas indonesia
fkoi=forum komunikasi ormas islam
fkp=fraksi karya pembangunan
fkpga=forum komunikasi pensiunan garuda
fkppi=forum komunikasi putra putri purnawirawan dan putra putri abri
fkppka=forum komunikasi pembinaan dan pengembangan kemampuan anak
fksh=forum kajian sosial humaniora
fksi=federasi karate seluruh indonesia
fkss=fakultas keguruan sastra dan seni
fkub=forum kerukunan umat beragama
flobamora=flores, sumba, timor, dan alor
flops=floating point operations per second
flotim=flores timur
fm=frequency modulation
fmcopd=faktor muka coba operasi plastik dulu
fmd=fluorescent multilayer disk
fmd-rom=fluorescent multilayer disk-read only memory
fmipa=fakultas matematika dan ilmu pengetahuan alam
fob=free on board
foc=free of charge
fol.=folio
foreri=forum rekonsiliasi rakyat irian
forki=federasi olahraga karate indonesia
fosko 66=forum, studi dan komunikasi 1966
fpbs=fakultas pendidikan bahasa dan seni
fpdi=fraksi partai demokrasi indonesia
fpga=field-programmable gate array
fpips=fakultas pendidikan ilmu pengetahuan sosial
fpm=fast page mode
fpmipa=fakultas pendidikan matematika dan ilmu pengetahuan alam
fpmr=forum pemuda dan mahasiswa untuk rakyat
fpok=fakultas pendidikan olahraga dan kesehatan
fpp=fraksi persatuan pembangunan
fpr=forum pengusaha reformasi
fps=frame per second
fptk=fakultas pendidikan teknologi kejuruan
fpu=floating point unit
fr.=frater
fretilin=frente revolucionaria do timoreste independente
fs=fakultas sastra
fsaa=full screen anti-aliasing
fsb=front side bus
fspsi=federasi serikat pekerja seluruh indonesia
ft.=foot, feet
ft=fakultas teknik
ftp=file transfer protocol
fu=fakultas ushuluddin
fud=fraksi utusan golongan
fug=fraksi utusan golongan
fui=forum umat islam
fv.=faillissementsverordening
fxsr=fast floating-point save and restore
g30s=gerakan 30 september
g30s-pki=gerakan 30 september partai komunis indonesia
g-30s-pki=gerakan 30 september partai komunis indonesia
ga=nggak
gaba=gamma-aminobutyric acid
gabsi=gabungan bridge seluruh indonesia
gadar=gawat darurat
gafeksi=gabungan forwarder dan ekspedisi indonesia
gaikindo=gabungan industri kendaraan bermotor indonesia
gal=gallon
galanita=gabungan sepak bola wanita
galasiswa=gabungan sepak bola mahasiswa
galatama=liga sepak bola utama
gam=gerakan aceh merdeka
gama=gadjah mada
ganefo=games of the new emerging forces
gapasdap=gabungan pengusaha angkatan sungai, danau dan penyeberangan
gapbesi=gabungan pabrik besi baja seluruh indonesia
gapekindo=gabungan perusahaan korek api indonesia
gapeknas=gabungan pelaksana kontruksi nasional
gapensi=gabungan pelaksana nasional seluruh indonesia
gapinas=gabungan pengusaha eksportir ikan hias nasional
gapki=gabungan pengusaha kelapa sawit indonesia
gapkindo=gabungan pengusaha karet indonesia
gapmmi=gabungan pengusaha makanan minuman indonesia
gappi=gabungan perusahaan penilai indonesia
gappindo=gabungan pengusaha perikanan indonesia
gappri=gabungan perserikatan pabrik rokok indonesia
gart=graphics address remapping table
gatek=gagap teknologi
gateng=garis tengah
gatikbi=gabungan agen tunggal dan industri kendaraan bermotor indonesia
gatt=general agreement on tariffs and trade
gaveksi=gabungan veem dan ekspedisi indonesia
gb=gigabyte
gbhn=garis-garis besar haluan negara
gbpp=garis besar program pengajaran
gbps=gigabyte per second
gbsi=gabungan buruh serikat independent
gcbi=gerakan cinta bahasa indonesia
gdi=graphical device interface
gdn=gerakan disiplin nasional
gdp=gross domestic product
gelora=gelangang olahraga
genset=generator set
gepeng=gelandangan dan pengemis
gerbangkertasusila=gersikjombangkertosonosurabayasidoarjolamongan
gerkatin=gerakan untuk kesejahteraan tunarungu indonesia
gerobak=gerombolan batak
gerpol=gerakan politik
gersamata=gerakan desa makmur merata
gestapo=geheime staatspolizei
gestapu=gerakan september tiga puluh
gestok=gerakan 1 oktober
gfd=gold finger device
gff=gold free fall
gg.=gang
ghz=gigahertz
gi=government issue
gia=garuda indonesia airways
giamm=gabungan industri alat-alat mobil dan motor
giman=gigi mancung
gino=gigi nongol
ginsi=gabungan importir nasional seluruh indonesia
girlan=pinggir jalan
girli=pingir kali
gkbi=gabungan koperasi batik indonesia
gkg=gabah kering giling
gki=gerakan kemanusiaan indonesia
gkj=gedung kesenian jakarta
gkp=gabah kering panen
gkpri=gabungan koperasi pegawai republik indonesia
gksi=gabungan koperasi susu indonesia
glamur=golongan lanjut usia
gm=general manager
gmf=garuda maintenance facility
gmki=gerakan mahasiswa kristen indonesia
gmn=bagaimana
gmni=gerakan mahasiswa nasional indonesia
gmpi=gerakan persaudaraan muslim indonesia
gmt=greenwich mean time
gna=ghana news agency
gnota=gerakan nasional orang tua asuh
gnp=gross national product
go=gonorrhoea
goi=government of indonesia
goleklemah=golongan ekonomi lemah
golkar=golongan karya
golpis=golongan pilih semua
golput=golongan putih
golput=golongan putih
gora=gogo rancah
gpa=grade point average
gpbsi=gabungan pengusaha bioskop seluruh indonesia
gpei=gabungan pengusaha ekspor indonesia
gpici=gabungan pengusaha industri cat indonesia
gpk=gerakan pemuda ka'bah
gpmt=gabungan perusahaan makanan ternak
gpo=general post office
gpp=gak apaapa
gppi=gabungan perusahaan perkebunan indonesia
gprs=general packet radio service
gps=global positioning system
gpu=graphics processing unit
gq=general quarters
grm=gerakan rakyat marhaen
gsm=global system for mobile communication
gso=general staff officer
gsr=gigabit switch router
gt=begitu
gudep=gugus depan
gunawan=gundul tapi menawan
guppi=gabungan usaha perbaikan pendidikan indonesia
h.=haji
h.c.=honoris causa
h=hijriah
haki=hak atas kekayaan intelektual
hakli=himpunan ahli kesehatan lingkungan indonesia
ham=hak asasi manusia
hamki=himpunan ahli manajemen konstruksi indonesia
handak=bahan peledak
hankam=pertahanan dan keamanan
hankamnas=pertahanan dan keamanan nasional
hankamrata=pertahanan dan keamanan rakyat semesta
hanra=pertahanan rakyat
hansip=pertahanan sipil
hanura=hati nurani rakyat
haornas=hari olahraga nasional
hapsak=hari peringatan kesaktian
hardiknas=hari pendidikan nasional
harganas=hari keluarga nasional
harkitnas=hari kebangkitan nasional
harlah=hari lahir
harm=high speed antiradiation missile
harpitnas=hari kejepit nasional
hati=hapus hukuman mati
hatiwasda=hakim tinggi pengawas daerah
hatti=himpunan ahli teknik tanah indonesia
hb=hemoglobin
hb=hindia belanda
hbs=hogere burger school
hcs=hollands chinese school
hdd=hard disk drive
hdii=himpunan desainer interior indonesia
hdl=high-density lipoprotein
heksmi=himpunan eksekutif muda indonesia
heln=hubungan ekonomi luar negeri
het=harga eceran tertinggi
hfi=himpuan fisika indonesia
hgb=hak guna bangunan
hgu=hak guna usaha
hi-fi=high fidelity
hik=hollandsche indische kweekschool
hiksi=himpunan industri kecil seluruh indonesia
himasita=himpunan mahasiswa proteksi tanaman
himni=himpunan masyarakat nuklir indonesia
himpala=himpunan mahasiswa pecinta alam
himpemi=himpunan pengusaha muatan indonesia
hinabi=himpunan industri alat berat indonesia
hiperkes=higiene perusahaan dan kesehatan
hipis=himpunan indonesia untuk pengembangan ilmu-ilmu sosial
hipmi=himpunan pengusaha muda indonesia
hippi=himpunan pengusaha putera indonesia
hipsi=himpunan pekerja sosial indonesia
hir=herziene indonesisch reglement
his=hollandsch inlandsche school
hiski=himpunan sarjana kesusastraan indonesia
hiswana=himpunan wiraswasta nasional
hj.=hajah
hkbp=huria kristen batak protestan
hkhpm=himpunan konsultan hukum pasar modal
hki=himpunan kawasan industri
hkpi=himpunan kerukunan pedagang indonesia
hksn=hari kesetiakawanan sosial nasional
hkti=himpunan kerukunan tani indonesia
hlm.=halaman
hln=hubungan luar negeri
hmi=himpunan mahasiswa islam
hmwi=himpunan manager wanita indonesia
hnsi=himpunan nelayan seluruh indonesia
ho=hongeroedeem
hoa=head of agreement
honda=honore daerah
hp=hand phone
hpbi=himpunan pembina bahasa indonesia
hph=hak pengusaha hutan
hphh=hak pemungutan hasil hutan
hpi=himpunan psikologi indonesia
hpj=himpunan pariwisata indonesia
hpmi=himpunan pengusaha motor indonesia
hpp=harga pembelian pemerintah
hppi=himpunan praktisi periklanan indonesia
hppia=himpunan pengajar dan peneliti indonesia di australia
hr=hari
hsbi=himpunan seni budaya islam
hsu=hulu sungai utara
htag=hambatan, tantangan, ancaman, dan gangguan
hti=hutan tanaman industri
hubad=hubungan angkatan darat
hubda=hubungan darat
hubdar=perhubungan darat
hubla=perhubungan laut
huij=himpunan usahawan indonesia jepang
humanika=himpunan masyarakat untuk kemanusiaan dan keadilan
humas=hubungan masyarakat
hupmas=hubungan masyarakat dan pemerintah
hut=hari ulang tahun
hvs=houtvrij schrijfpapier
hwk=himpunan wanita karya
i.c.=in casu
i.e.=id est
i/o=input / output
iaae=international association of agricultural economists
iaaf=international amateur athletic federation
iaba=international amateur boxing association
iad=ilmu alamiah dasar
iaea=international atomic energy agency
iagi=ikatan ahli geologi indonesia
iai=ikatan akuntan indonesia
iain=institut agama islam negeri
iakmi=ikatan ahli kesehatan masyarakat indonesia
iampi=ikatan ahli manajemen proyek indonesia
iap=international airport
ias=indonesian air show
iasii=ikatan audit sistem informasi indonesia
iata=international air transport association
iato=ikatan ahli teknik otomotif
iatpi=ikatan ahli teknik penyehatan dan teknik lingkungan indonesia
ibd=ilmu budaya dasar
ibf=international badminton federation
ibh=indeks biaya hidup
ibi=ikatan bidan indonesia
ibid.=ibidem
ibm=international business machines
ibra=indonesian bank restructuring agency
ibt=indonesia bagian timur
icao=international civil aviation organization
iccs=international commission of control and supervision
iccu=intensive coronary care unit
icel=indonesian center for environmental law
icip=indonesian cleaner industrial production
icmi=ikatan cendekiawan muslim indonesia
icu=intensive care unit
icw=indonesian corruption watch
icwa=indonesian council on world affairs
id.=idem
ida=intenational development association
idai=ikatan dokter anak indonesia
idb=islamic development bank
idi=ikatan dokter indonesia
idt=inpres desa tertinggal
ifad=international fund for agricultural development
ifo=identified flying object
iftu=international federation of trade unions
iga=indonesian gas association
igd=instalasi gawat darurat
iggi=inter-governmental group on indonesia
igos=indonesia go open source
igtki=ikatan guru taman kanak-kanak indonesia
ihh=iuran hasil hutan
ihsg=indeks harga saham gabungan
iiee=indonesian institutes for energy economics
iip=institut ilmu pemerintahan
iitf=indonesia information technology federation
ijeg=indonesian japanese european group
ijti=ikatan jurnalis televisi indonesia
ikadi=ikatan dai indonesia
ikadin=ikatan advokat indonesia
ikafi=ikatan ahli farmakologi indonesia
ikapi=ikatan penerbit indonesia
ikasi=ikatan anggar seluruh indonesia
ikip=institut keguruan dan ilmu pendidikan
ikj=institut kesenian jakarta
ikka=ikatan kesejahteraan keluarga abri
ikorti=ikatan ortodontis indonesia
ikpi=ikatan konsultan pajak indonesia
ikpm=ikatan perancang mode indonesia
ikpn=induk koperasi pegawai negeri
ilmea=industri logam, mesin, elektronika dan aneka
ilo=international labour organization
iluni=ikatan alumni universitas indonesia
imami=ikatan masjid dan mushalla indonesia
imb=izin mendirikan bangunan
imf=international monetary fund
imi=ikatan motor indonesia
imlde=industri mesin logam dasar dan elektronika
imm=ikatan mahasiswa muhammadiyah
imo=international meteorological organization
impact=inspiration for managing people's action
ims-gt=indonesia-malaysia-singapore growth triangle
imtgt=indonesianmalaysiathailand growth triangle
imt-gt=indonesian-malaysia-thailand growth triangle
ina=iraq news agency
inaca=asosiasi perusahaan penerbangan sipil indonesia
inalum=indonesia asahan aluminium
indag=industri dan perdagangan
indosat=indonesian satellite corporation
indra=indonesian debt restructuring agency
infa=indonesian forwarders association
infid=international ngo forum on indonesian development
info=informasi
ini=ikatan notaris indonesia
inkindo=ikatan nasional konsultan indonesia
inkopar=induk koperasi karyawan
inkopkar=induk koperasi karyawan
inkopol=induk koperasi kepolisian
inma=international newspaper marketing association
inmas=intensifikasi masyarakat
inp=indonesian national police
inpi=indonesian ngos partners initiatives
inpi-pact=indonesian ngos partners initiatives private agencies collaborating together
inpres=instruksi presiden
inra=institut national de la recherche agronomique
inri=iesus nazarenus rex iudaeorum
insa=indonesian national shipowners association
insus=intensifikasi khusus
intag=inventarisasi dan tata guna hutan
intakindo=ikatan nasional tenaga ahli konsultan indonesia
intelsat=international telecommunications satellite
interfet=international force for east timor
interpol=international police
inti=perhimpunan indonesia tionghoa
intim=indonesia timur
ioc=international olympic committee
ipa=ilmu pengetahuan alam
ipal=instalasi pengelolaan air limbah
ipb=institut pertanian bogor
ipbdtd=ikatan perguruan bela diri tenaga dalam
ipcos=institute for policy and community studies
ipda=inspektur polisi dua
ipdn=institut pemerintahan dalam negeri
ipeda=iuran pembangunan daerah
iperindo=ikatan perusahaan industri kapal indonesia
ipgi=ikatan perancang grafis indonesia
iphi=ikatan penasihat hukum indonesia
ipi=ikatan pustakawan indonesia
ipki=ikatan pendukung kemerdekaan indonesia
ipkin=ikatan pemakai komputer indonesia
ipmi=ikatan perancang mode indonesia
ipoleksosbud=ideologi, politik, ekonomi, sosial, dan budaya
ippf=international planned parenthood federation
ippi=ikatan pemerhati psikologi industri
ippui=ikatan profesi penilai usaha indonesia
ips=ilmu pengetahuan sosial
ipsi=ikatan pencak silat indonesia
iptek=ilmu pengetahuan dan teknologi
iptn=industri pesawat terbang nusantara
iptu=inspektur polisi satu
ipu=interparliamentary union
iq=intelligence quotient
ir.=insinyur
ir=infrared
iramasuka=irian, maluku, sulawesi, dan kalimantan
ireda=iuran rehabilitasi daerah
irja=irian jaya
irjabar=irian jaya barat
irjen=inspektur jenderal
irjenpol=inspektur jenderal polisi
irna=islamic republic news agency
irpa=indonesian risk professional association
irri=international risk research institute
irup=inspektur upacara
isai=institut studi arus informasi
isbn=international standard book number
isei=ikatan sarjana ekonomi indonesia
isfi=ikatan sarjana farmasi indonesia
ishi=institute of study on human interests
isi=ikatan sekretaris indonesia
isj=institut sosial jakarta
iski=ikatan sarjana komunikasi indonesia
iso=international organization for standardization
isoi=ikatan sarjana oseanografi indonesia
isp=internet service provider
ispi=ikatan sarjana pendidikan indonesia
issi=ikatan sarjana sastra indonesia
issn=international standard serial number
isti=institut seni tari indonesia
istora=istana olahraga
iswi=ikatan sarjana wanita indonesia
it.=inspektorat
itb=institut teknologi bandung
iti=institut teknologi indonesia
itjen=inspektorat jenderal
ito=international treaty organization
itpb=indonesia tourism promotion board
itpc=indonesia trade promotion center
itra=indonesia tours and travel association
its=institut teknologi surabaya
itto=international tropical timber organization
itu=international telecommunication union
iu=international unit
iud=intrauterine device
iwapi=ikatan wanita pengusaha indonesia
jabar=jawa barat
jabekta=jakartabogortangerang
jabodetabek=jakarta-bogor-depok-tangerang- bekasi
jabon=jawaambon
jabotabek=jakartabogortangerangbekasi
jadel=jawa deli
jadup=jatah hidup
jagorawi=jakarta-bogor-ciawi
jagowari=jakartabogorciawi
jakbar=jakarta barat
jakgung=jaksa agung
jakprom=yayasan promosi jakarta
jakpus=jakarta pusat
jaksel=jakarta selatan
jaktim=jakarta timur
jakut=jakarta utara
jal=japan airlines
jalintim=jalur lintas timur
jamda=jambore daerah
jamnas=jambore nasional
jampidsus=jaksa agung muda tindak pidana khusus
jampidum=jaksa agung muda tindak pidana umum
jamsostek=jaminan sosial tenaga kerja
jantop=jawatan topografi
jardiknas=jaringan pendidikan nasional
jasuka=jawa, sumatra, kalimantan
jatam=jaringan advokasi tambang
jateng=jawa tengah
jatim=jawa timur
jats=jakarta automated trading system
jaya=jakarta raya
jd=jadi
jend.=jenderal polisi
jerbar=jerman barat
jertim=jerman timur
jeto=japan external trade organization
jetro=japan external trade organization
jfca=jakarta foreign correspondents association
jg=juga
jgn=jangan
jibor=jakarta interbank offered rate
jica=japan international cooperation agency
jiep=jakarta industrial estate pulogadung
jihandak=penjinak bahan peledak
jil=jaringan islam liberal
jim=jakarta informal meeting
jirolu=siji, loro, telu
jitc=jakarta international trade fair corporation
jjj=jaringan jagat jembar
jktbm=jawatankuasa tetap bahasa melayu malaysia
jl.=jalan
jln.=jalan
jna=jordan news agency
jnj=janji
jo.=juncto
jo=juncto
joglosemar=jogja-solo-semarang
jpkm=jaminan pemeliharaan kesehatan masyarakat
jplh=jaringan perpustakaan lingkungan hidup
jps=jaring pengaman sosial
jr.=junior
jsx=jakarta stock exchange
jubir=juru bicara
jukir=juru pakir
juklak=petunjuk pelaksanaan
jukminum=petunjuk administrasi umum
juknis=petunjuk teknis
jumantik=juru pemantau jentik
jupen=juru penerang
jurdil=jujur adil
jurdil=jujur dan adil
jurkam=juru kampanye
jurkam=juru kampanye
jwb=jawab
k.=kiai
k.h.=kiai haji
k.l.=kurang lebih
ka=kepala
ka=kereta api
kaa=konferensi asia afrika
kab.=kabupaten
kabag=kepala bagian
kabi=kesatuan aksi buruh indonesia
kabid=kepala bidang
kabulog=kepala badan urusan logistik
kadapol=kepala daerah kepolisian
kades=kepala desa
kadin=kamar dagang indonesia
kadispen=kepala dinas penerangan
kadit=kepala direktorat
kadiv=kepala divisi
kadolog=kepala depot logistik
kagi=kesatuan aksi guru indonesia
kahmi=korps alumni himpunan mahasiswa islam
kai=kereta api indonesia
kajari=kepala kejaksanaan negeri
kajati=kepala kejaksanaan tinggi
kakanbangdes=kepala kantor pembangunan desa
kakanwil=kepala kantor wilayah
kakin=kebaktian agama khonghucu indonesia
kalbar=kalimantan barat
kalsel=kalimantan selatan
kalteng=kalimantan tengah
kaltim=kalimantan timur
kalut=kalimantan utara
kami=kesatuan aksi mahasiswa indonesia
kammi=kesatuan aksi mahasiswa muslim indonesia
kamra=keamanan rakyat
kamtib=keamanan dan ketertiban
kamtibmas=keamanan dan ketertiban masyarakat
kamurri=komite aksi mahasiswa untuk reformasi rakyat indonesia
kancab=kantor cabang
kancil=kendaraan kecil
kandep=kantor departemen
kanker=kantong kering
kanwil=kantor wilayah
kap=kualitas aktiva produktif
kapci=komite advokasi penyandang cacat indonesia
kapet=kawasan pengembangan ekonomi terpadu
kapi=kesatuan aksi pelajar indonesia
kapilres=kepala kepolisian resor
kaplet=kapsul tablet
kapol=kepala polisi
kapolda=kepala polisi daerah
kapolres=kepala polisi resort
kapolri=kepala kepolisian republik indonesia
kapolsek=kepala polisi sektor
kapolwil=kepala polisi wilayah
kapt.=kapten
kaptan=kapur pertanian
kapus=kepala pusat
kapuspen=kepala pusat penerangan
karakterdes=kader penggerak teritorial desa
karma=koalisi aksi reformasi mahasiswa aceh
karo=kepala biro
karpeg=kartu pegawai
kasaker=kepala satuan kerja
kasat=kepala satuan
kasdam=kepala staf daerah militer
kasgar=kepala staf garnisun
kasi=kepala seksi
kasis=kartu isteri
kassospol=kepala staf sosial / politik
kastaf=kepala staf garnisun
kaster=kepala staf teritorial
kasub=kepala sub
kasubbag=kepala subbagian
kasubbid=kepala subbidang
kasum=kepala staf umum
katak=kepala botak
kateda=kekuatan aliran tenaga dalam
katepe=kartu tanda penduduk
katesu=kekuatan aliran tenaga suci
kaur=kepala urusan
kawitel=kantor wilayah telekomunikasi
kb=keluarga berencana
kbbi=kamus besar bahasa indonesia
kbh=kontrak bagi hasil
kbi=kamus bahasa indonesia
kbih=kelompok bimbingan ibadah haji
kbr=kabar
kbri=kedutaan besar republik indonesia
kbu=kamar bicara umum
kc=kantor cabang
kcbi=keluarga cendekiawan budhis
kcmp=kredit cicilan mobil penumpang
kcna=korean central news agency
kcsm=kredit cicilan sepeda motor
kdei=kliring deposit efek indonesia
kdki=kepala daerah khusus ibukota
kdp=kecamatan development project
kdpk=ketentuan dan prosedur kerja
kec.=kecamatan
kedubes=kedutaan besar
kejagung=kejaksaan agung
kejakgung=kejaksaan agung
kejar=kelompok belajar
kejari=kejaksaan negeri
kejati=kejaksaan tinggi
kejurnas=kejuaraan nasional
kekar malindo=keris kartika malaysiaindonesia
kel.=kelurahan
kelompencapir=kelompok pendengar, pembaca, pemirsa
kelompensipedes=kelompok pendengar siaran pedesaan
kenop-15=kebijaksanaan 15 november
kep.=keputusan
keppres=keputusan presiden
kepsek=kepala sekolah
kere=kelompok remaja
kesbang=kesatuan bangsa
kesko=kesatuan komando
kesra=kesejahteraan rakyat
ketupat=keadaan, waktu, tempat
kft=karyawan film dan televisi
kg=kilogram
kgb=komitet gosudarstvennoy bezopasnosti
khn=komisi hukum nasional
kiaa=konferensi islam asia afrika
kib=kawasan industri batamindo
kiban=kompi bantuan
kibus=kaki busuk
kie=komunikasi informasi edukasi
kik=kredit investasi kecil
kim=kartu izin masuk
kima=kompi markas
kimpraswil=permukiman dan prasarana wilayah
kims=kartu izin masuk sementara
kino=kelompok induk organisasi
kip=kampung improvement programme
kipam=kesatuan intai para amfibi
kipan=kompi senapan
kipm=kartu identitas penduduk musiman
kipnas=kongres ilmu pengetahuan nasional
kipp=komite independen pemantau pemilu
kisdi=komite indonesia untuk solidaritas dunia islam
kiss=kisah seputar selebriti
kiss=koordinasi, integrasi, sinkronisasi, simplifikasi
kitas=kartu izin tinggal terbatas
kitlv=koninklijk instituut voor taal-, land-en volkenkunde
kj=kelas jauh
kk=kepala keluarga
kkbs=keluarga kecil bahagia sejahtera
kkgj=koperasi kesejahteraan guru jakarta
kkk=ku klux klan
kkl=kuliah kerja lapangan
kkn=korupsi kolusi nepotisme
kkoal=korps komando angkatan laut
kko-al=korps komando angkatan laut
kkp=kredit ketahanan pangan
kkpa=kredit kepada koperasi primer untuk anggotanya
kkpatri=kkpa dalam rangka pembiayaan program intensifikasi tebu rakyat
kkps=kelompok penyelenggara pemungutan suara
kkr=komisi keadilan dan rekonsiliasi
kku=kredit kelayakan usaha
kl=kalau
kl=kuala lumpur
klbi=kredit likuidasi bank indonesia
klh=kependudukan dan lingkungan hidup
klii=kamus lengkap indonesiainggris
kloter=kelompok terbang
km=kapal motor
km=kilometer
kmb=konferensi meja bundar
kmd=koran masuk desa
kmh, kmph=kilometer per hour
kmhdi=kesatuan mahasiswa hindu dharma indonesia
kmkp=kredit modal kerja permanen
kmpan=komite mahasiswa pemuda aceh nusantara
kmps=kilometer per second
kms=kartu menuju sehat
kn=knot
kni=kantor berita nasional indonesia
knil=koninklijk nederlands indisch leger
knip=komite nasional indonesia pusat
knkt=komite nasional keselamatan transportasi
knl=kenal
knpi=komite nasional pemuda indonesia
ko=knock out
ko=komando
koanda=komando antar daerah
kodaeral=komando daerah angkatan laut
kodak=komando daerah kepolisian
kodam=komando daerah militer
kodamar=komando daerah maratim
kodau=komando daerah angkatan udara
kodia=kota madya
kodiklat=komando pembina doktrin, pendidikan dan latihan
kodim=komando distrik militer
kodya=kota madya
kogab=komando gabungan
kohanudnas=komando pertahanan udara nasional
kohanudpas=komando pertahanan udara pasif
koi=komite olahraga indonesia
kolaga=komando mandala siaga
kolakops=komando pelaksanaan operasional
kombes=komisaris besar
kombespol=komisaris besar polisi
komdis=komisi disiplin
komjenpol=komisaris jenderal polisi
komnas=komisi nasional
komnasham=komisi nasional hak asasi manusia
kompol=komisaris polisi
komres=komando resort
komresko=komand resort kota
komsat=komunikasi satelit
komsek=komando sektor
komsekko=komando seksi kepolisian kota
komseko=komando seksi kepolisian kota
komsov=komunis sovyet
komtabes=komando kota besar
komtiong=komunis tiongkok
koni=komite olahraga nasional indonesia
konjen=konsulat jenderal
konphalindo=konsorsium nasional untuk pelestarian hutan dan alam indonesia
kontras=komisi untuk orang hilang dan korban tindak kekerasan
kopaja=koperasi angkutan jakarta
kopasandha=komando pasukan sandi yudha
kopasgat=komando pasukan gerak cepat
kopaska=komando pasukan katak
kopassus=komando pasukan khusus
kopatdara=komando pasukan tempur udara
kopbumi=konsorsium pembela buruh migran indonesia
kopda=kopral dua
kopertais=koordinasi perguruan tinggi agama islam
kopertis=koordinasi perguruan tinggi swasta
kopindo=koperasi pembatikan indonesia
kopkamtib=komando operasi pemulihan keamanan dan ketertiban
kopti=koperasi produsen tahu tempe indonesia
koptu=kopral satu
kopur=komando tempur
koramil=komando rayon militer
korem=komando resort militer
koresta=komando resor kepolisian kota
koresta=komando resort kepolisian kota
korlap=koordinator lapangan
kormin=koordinator administrasi
korpri=korps pegawai republik indonesia
korsel=korea selatan
kortek=koordinator teknis
korut=korea utara
korwil=koordinator wilayah
kosatgas=komando satuan tugas
kosek=komando sektor
kosgoro=kesatuan organisasi serba guna gotong royong
kostrad=komando strategi angkatan darat
kostranas=komando strategi nasional
kosubdahan=komando subdaerah pertahanan
kosubdim=komando subdaerah militer
kosubhandamar=komando subpertahanan daerah maritim
kosubmar=komando submaratim
kosubmarlanal=komando submaratim pangkalan angkatan laut
kosubmarsional=komando submaratim stasion angkatan laut
kosubsek hansiphanra=komando subdistrik pertahanan rakyat
kotif=kota administratif
kotipa=kolera, tifus, paratifus
koveri=koperasi veteran republik indonesia
kowabri=korps wanita angkatan bersenjata republik indonesia
kowad=korps wanita angkatan darat
kowal=korps wanita angkatan laut
kowalpan=komando pengawal pantai
kowani=kongres wanita indonesia
kowarteg=koperasi warung tegal
kowau=korps wanita angkatan udara
kowaveri=korps wanita veteran republik indonesia
kowilhan=komando wilayah pertahanan
koyonif=komando batalyon infantri
koyonpom=komando batalyon polisi militer
koyonpur=komando batalyon pertempuran
koyonzipur=komando batalyon zeni tempur
kp=kepala pusat
kpa=kursus pegawai administrasi
kpaa=kursus pegawai administrasi tingkat atas
kpb=kebijakan perkreditan bank
kpba=kelompok pecinta bacaan anak-anak
kpd=kepada
kpg=kursus pendidikan guru
kph=kantor pengendalian harga
kpi=komisi penyiaran indonesia
kpk=komisi pemberantasan korupsi
kpkn=kantor perbendaharaan dan kas negara
kpkpn=komisi pemeriksa kekayaan penyelenggara negara
kplp=kesatuan penjaga laut dan pantai
kpm=koninklijke paketvaart maatschappij
kpmm=kewajiban pemenuhan modal minimum
kpn=kantor perbendaharaan negara
kpn=kapan
kpp=kantor pelayanan pajak
kppk=ketentuan pelaksanaan prosedur kerja
kppn=kantor pusat perbendaharaan negara
kppri=kesatuan penerus perjuangan republik indonesia
kpps=kelompok penyelenggara pemungutan suara
kppsln=kelompok penyelenggara pemungutan suara luar negeri
kppu=komisi pengawas persaingan usaha
kpr=kredit pemilikan rumah
kpu=komisi pemilihan umum
kpu=komisi pemilihan umum
kpud=komisi pemilihan umum daerah
kra=kursus reguler angkatan
kramtung=kramat tunggak
krap=komunikasi radio antarpenduduk
krc=kayu rimba campuran
krd=kereta rel diesel
kremi=kredit mini
kri=kapal republik indonesia
kribo=kriting bohong
krisna=partai kristen nasional indonesia
kristal=krisis total
krl=kereta rel listrik
krm=kirim
krn=karena
krs=kartu rencana studi
ks=kode sandi
ksa=kepala silau asing
ksab=kepala staf angkatan bersenjata
ksad=kepala staf angkatan darat
ksal=kepala staf angkatan laut
ksau=kepala staf angkatan udara
ksll=konstruksi sarang laba-laba
kso=kerja sama operasi
ksob=kupon sumbangan olahraga berhadiah
kt=karang taruna
kt=kita
kta=kartu tanda anggota
kti=kesatuan tani indonesia
ktm=konferensi tingkat menteri
ktmu=ketemu
ktn=komisi tiga negara
ktnb=kerja sama teknik antar negara berkembang
ktp=kartu tanda penduduk
ktr=kantor
ktt=konferensi tingkat tinggi
kttr=koperasi tani tebu rakyat
ktu=kepala bagian tata usaha
ku=kuasa usaha
kua=kantor urusan agama
kuai=kuasa usaha ad interim
kuari=kuasa usaha republik indonesia
kub=kelompok usaha bersama
kubi=kamus umum bahasa indonesia
kud=koperasi unit desa
kuh perdata=kitab undangundang hukum perdata
kuhap=kitab undang-undang hukum acara pidana
kuhd=kitab undangundang hukum dagang
kuhdt=kitab undangundang hukum disiplin tentara
kuhp=kitab undang-undang hukum pidana
kuhper=kitab undangundang hukum perdata
kuhpt=kitab undang-undang hukum pidana tentara
kuhs=kitab undangundang hukum sipil
kuk=kredit usaha kecil
kukesra=kredit usaha keluarga sejahtera
kukmi=kerukunan usahawan kecil dan menengah indonesia
kuli=kultus individu
kuna=kuwait news agency
kundak=kunjungan mendadak
kup=kantor urusan pegawai
kupedes=kredit umum pedesaan
kuper=kurang pergaulan
kur=kredit usaha rakyat
kurtup=kurung tutup
kurupsi=kuras uang rakyat untuk pribadi sendiri
kusuka=kutipan surat kabar
kut=kredit usaha tani
kuud=koperasi unit usaha desa
kv=kilovolt
kva=kilovolt ampere
kva=kilovolt-ampere
kva=kurs valuta asing
kw=kilowatt
kw=kwartal
kwada=kuartir daerah
kwarcab=kuartir cabang
kwarnas=kuartir nasional
kwh=kilowatt-hour
kwi=konferensi wali gereja indonesia
kwj=kilowatt jam
kwk=koperasi wahana kalpika
kwt=kawat
kwtl=kartu wajib tanda lapor
ky=komisi yudisial
l.l.=lalu lintas
l/c=letter of credit
l/k=laporan keuangan
l=large
laba=lapis baja
labkrim=laboratorium kriminal
ladk=laporan awal dana kampanye
lai=lembaga alkitab indonesia
laka=kecelakaan
laka=lembaga adat dan kebudayaan aceh
lakpus=pelaksanaan pusat
laksda=laksamana muda
laksdya=laksamana madya
laksma=laksamana pertama
laksus=pelaksana khusus
laksusda=pelaksana khusus daerah
lamindo=latin americaindonesia
lamp.=lampiran
lan=local area network
lansia=lanjut usia
lantamal=pangkalan utama angkatan laut
lantastuskim=lalu lintas dan status keimigrasian
lanud=landasan udara
lanuma=pangkalan udara utama
lapan=lembaga penerbangan dan antariksa nasional
lapas=lembaga pemasyarakatan
lapud=lapangan udara
laser=light amplification by stimulated emission of radiation
lasik=laser-assisted in situ keratomileusis
latgab=latihan gabungan
latin=lembaga alam tropika indonesia
latma=latihan bersama
lb=libra
lbatani=lembaga baluse tano niha
lbbu=laporan bulanan bank umum
lbh=lembaga bantuan hukum
lbhi=lembaga bantuan hukum indonesia
lbi=lembaga biblika indonesia
lbn=lembaga biologi nasional
lbph kosgoro=lembaga bantuan dan pengembangan hukum kosgoro
lc=letter of credit
lcd=liquid crystal display
ld=laser disc
ldii=lembaga dakwah islam indonesia
ldkm=latihan dasar kepemimpinan mahasiswa
ldt=lightning data transport
led=light-emitting diode
leha=lelaki hawa
lei=lembaga ekolabel indonesia
leknas=lembaga ekonomi kemasyarakatan nasional
lekra=lembaga kebudayaan rakyat
lembergar=lembaran bergambar
lemhanas=lembaga pertahanan nasional
lemigas=lembaga minyak dan gas bumi
lemot=lemah otak
lempusdika=lembaga pusat pendidikan dan pelatihan pramuka
letda=letnan dua
letjen=letnan jenderal
lettu pnb=letnan satu penerbangan
lettu=letnan satu
lfg=lembaga geologi nasional
lfk=laporan fasilitas kredit
lfn=lembaga fisika nasional
lg=lagi
lgn=lembaga geologi nasional
lhi=lembaga humor indonesia
lhkpn=laporan harta kekayaan pejabat negara
lht=lihat
lifo=last in, first out
lik=lembaga inventarisasi kehutanan
lin=liga indonesia-nederland
linmas=perlindungan masyarakat
linud=lintas udara
lions=liberty, intelligence, our nation's safety
lipi=lembaga ilmu pengetahuan indonesia
litbang=penelitian dan pengembangan
litsus=penelitian khusus
litt.=literarum
lkbb=lembaga keuangan bukan bank
lkbn=lembaga kantor berita nasional
lkim=lomba karya ilmiah mahasiswa
lkir=lomba karya ilmiah remaja
lkm=latihan kepemimpinan mahasiswa
lkmd=lembaga ketahanan masyarakat desa
lkpu=lembaga konsultasi pemilihan umum
lktm=lomba karya tulis mahasiswa
ll.b=legum baccalaureus
ll.d=legum doctor
lmt=local mean time
lmv=lembaga modal ventura
ln=lembaran negara
lng=liquefied natural gas
lo=liaison officer
loc cit.=loco citato
loc. cit.=loco citato
loda=lotto daerah
log.=logistik
log=logistik
loi=letter of intent
lola=lonte lanang
lolapil=loka latih keterampilan
lon=lembaga oseanologi nasional
lp=lembaga pemasyarakatan
lp2k=lembaga perlindungan dan pembinaan konsumen
lp2p=laporan pajak-pajak pribadi
lp3es=lembaga penelitian, pendidikan, dan penerangan ekonomi dan sosial
lp3i=lembaga pendidikan dan pengembangan profesi indonesia
lp3m=lembaga pengkajian pedesaan, pantai, dan masyarakat
lpam=lembaga pencerahan dan advokasi masyarakat
lpg=liquefied petroleum gas
lpik=lembaga pengembangan informasi dan komunikasi
lpir=lomba penelitian ilmiah remaja
lpkb=lembaga pembina kesatuan bangsa
lpkj=lembaga pendidikan kesenian jakarta
lpp=lembaga penelitian pendidikan
lppdk=laporan penerimaan dan pengeluaran dana kampanye
lpph=lembaga penelitian penyakit hewan
lppm=lembaga pendidikan dan pembinaan manajemen
lppu=lembaga pendidikan penerbangan udara
lpsdk=laporan penerimaan sumbangan dana kampanye
lpsi=lembaga persahabatan swedia indonesia
lpsk=lembaga perlindungan saksi dan korban
lpsm=lembaga pembinaan sosial masyarakat
lptk=lembaga pendidikan tenaga keguruan
lptq=lembaga pengembangan tilawatil quran
lpu=lembaga pemilihan umum
lrkn=lembaga riset kebudayaan nasional
ls=lintang selatan
lsaf=lembaga studi agama dan filsafat
lsbu=laporan sandi bank umum
lsd=lembaga sosial desa
lsf=lembaga sensor film
lsi=lembaga survei indonesia
lsm=lembaga swadaya masyarakat
lsn=lembaga sandi negara
lsp=lembaga studi pengembangan
lsppi=lembaga sinematik pusat perfilman indonesia
lta=lembaga tenaga atom
ltd.=limited
ltd=lembaga tranfusi darah
ltpp=lembaga teknis pelaksana program
lu=lintang utara
luber=langsung, umum, bebas, dan rahasia
luber=langsung, umum, bebas, dan rahasia
luk=laboratorium uji konstruksi
lun=logical unit number
lvd=low-voltage differential
lvri=legiun veteran republik indonesia
lw=long wave
lwt=lewat
lz=landing zone
m.a.=master of arts
m.ag.=magister agama
m.b.a.=master of business administration
m.d.=medicinae doctor
m.hum.=magister humaniora
m.kes.=magister kesehatan
m.kom.=magister komunikasi
m.m.=magister manajemen
m.p.=magister pertanian
m.p.a.=master of public administration
m.p.h.=master of public health
m.pd.=magister pendidikan
m.ph.=master of philosophy
m.sc.=master of science
m.si.=magister sains
m.sn.=magister seni
m.t.=magister teknik
m=masehi
ma=mahkamah agung
ma=sama
mab=man and biosphere program
mabak=maskar besar kepolisian
mabal=maskar besar tni angkatan laut
mabau=maskar besar tni angkatan udara
mabbim=majelis bahasa brunei darussalam- indonesia-malaysia
mabes=markas besar
mabesad=maskar besar tni angkatan darat
mabim=majelis agama brunei darussalam- indonesia-malaysia
mac=media access control
madrali=maduraaustrali
magabut=makan gaji buta
mahatma=maju sehat bersama
mahmilti=mahkamah militer tinggi
mahmilub=mahkamah militer luar biasa
mai=masyarakat akuakultur indonesia
makin=majelis agama khonghucu indonesia
makodam=markas komando daerah militer
malari=malapeteka 15 januari
malteng=maluku tengah
malu=mantri kehutanan dan lurah
malut=maluku utara
man=madrasah aliyah negeri
mani=masyarakat anti nuklir indonesia
manikebu=manifesto kebudayaan
manipol=manifesto politik
manula=manusia usia lanjut
maperma=masa perkenalan mahasiswa
mappi=masyarkat profesi penilai indonesia
mapram=masa prabakti mahasiswa
mapras=masa prabakti siswa
mara=majlis amanah rakyat
markus=makelar kasus
mastel=masyarakat telematika indonesia
masyumi=majelis syuro muslimin indonesia
matakin=majelis tinggi agama khonghucu indonesia
matarmaja=malang-blitar-madiun-jakarta
mayjen=mayor jenderal
mb=megabyte
mba=master of business administration
mbps=megabyte per second
mc=master of ceremonies
mca=micro channel architecture
mce=machine check exception
mcga=multi-color graphic array
mck=mandi, cuci, kakus
md=medicinae doctor
mdf=multi donor fund
mdi=mejelis dakwah islamiyah
mdram=multibank dynamic random access memory
mea=masyarakat ekonomi asean
mee=masyarkat ekonomi eropa
melindo=melayuindonesia
mems=micro-electromechanical systems
mena=middle east news agency
menag=menteri agama
menaker=menteri tenaga kerja
menakertrans=menteri tenaga kerja dan transmigrasi
menbudpar=menteri kebudayaan dan pariwisata
mendagri=menteri dalam negeri
mendikbud=menteri pendidikan dan kebudayaan
mendiknas=menteri pendidikan nasional
meneg=menteri negara
menegsus=menteri negara khusus
menhan=menteri pertahanan
menhankam=menteri pertahanan dan keamanan
menhubtel=menteri perhubungan dan telekomunikasi
menkeh=menteri kehakiman
menkes=menteri kesehatan
menkesra=menteri kesajahtteraan rakyat
menkeu=menteri keuangan
menkimpraswil=menteri permukiman, prasarana, dan wilayah tertinggal
menko ekku dan wasbang=menteri koordinator bidang ekonomi dan keuangan, dan pengawasan pembangunan
menko=menteri koordinator
menkominfo=menteri komunikasi dan informatika
menkop=menteri koperasi
menkumdang=menteri hukum dan perundang-undangan
menlu=menteri luar negeri
menmud seskab=menteri muda sekretaris kabinet
menmud=menteri muda
menpan=menteri negara pendayagunaan aparatur negara
menparpostel=menteri pariwisata, pos, dan telekomunikasi
menpen=menteri penerangan
menpera=menteri negara perumahan rakyat
menperbu=menteri perburuan
menperdag=menteri perdagangan
menperhub=menteri perhubungan
menperindag=menteri perindustrian dan perdagangan
menpertam=menteri pertambangan
menpora=menteri negara pemuda dan olahraga
menristek=menteri negara riset dan teknologi
mensesneg=menteri sekretaris negara
mensos=menteri sosial
mentahut=menteri pertanian dan kehutanan
mentamben=menteri pertambangan dan energi
mentan=menteri pertanian
mentanhut=menteri pertanian dan kehutanan
mentrans=menteri transmigrasi
mentranskop=menteri transmigrasi dan koperasi
menwa=resimen mahasiswa
metro jaya=metropolitan jaya
mflops=million of floating point operations per second
mfm=modified frequency modulation
mgkn=mungkin
mgr.=monscigneur
mgr.=monseignor
mid=military intelligence department
migas=minyak dan gas bumi
miker=minuman keras
miki=masyarakat komik indonesia
mikol=minuman beralkohol
milat=militer atase
min=madrasah ibtidaiah negeri
mippa=masyarakat indonesia pencinta pers alternatif
mips=million instruction per second
miras=minuman keras
misbar=kalau gerimis, penonton bubar
mk=mahkamah konstitusi
mkdk=mata kuliah dasar kejuruan
mkdu=mata kuliah dasar umum
mkgr=musyawarah kekeluargaan gotong royong
mkgr=musyawarah kekeluargaan gotong royong
mkk=mata kuliah kejuruan
mkp=mata kuliah pelengkap
mli=masyarakat linguistik indonesia
mls=malas
mmp=metode membaca permulaan
mmx=multi-media extensions
mna=merpati nusantara airlines
mnt=minta
mobec=motor becak
mobnas=mobil nasional
mocin=motor cina
moge=motor gede
moko=mobil toko
monas=monumen nasional
monta=mongolian telegraphics agency
motcin=motor cina
mou=memorandum of understanding
mp=military police
mpb=mesin pesawat bantu
mph=miles per hour
mpi=masyarakat perhutanan indonesia
mpo=menghitung pajak orang
mpp=masa persiapan pensiun
mpr=majelis permusyawaratan rakyat
mprs=majelis perwakilan rakyat sementara
mps=menghitung pajak sendiri
mr.=meester in de rechten
mrp=majelis rakyat papua
mrs.=mistress
ms=manuscript
ms=microsoft
msh=masih
msk=masuk
mski=meskipun
mti=masyarakat transparansi indonesia
mtn=madrasah tsanawiyah negeri
mtow=maximum take off weight
mtq=musabaqah tilawatil qur'an
mu=majelis umum
mubes=musyawarah besar
mui=majelis ulama indonesia
mujaib=mujarab dan ajaib
muker=musyawarah kerja
mukernas=musyawarah kerja nasional
mulo=meer uitgebreid lager onderwijs
munas=musyawarah nasional
munaslub=musyawarah nasional luar biasa
munmen=muntah dan mencret
muntaber=muntah dan berak
muri=museum rekor indonesia
musda=musyawarah daerah
musker=musyawarah kerja
muspida=musyawarah pimpinan daerah
muspika=musyawarah pimpinan kecamatan
muspin=musyawarah pimpinan
muswil=musyawarah wilayah
mw=medium wave 
n.b.=notabene
n.n.=nomen nescio
n=dan
nad=nanggroe aceh darussalam
nafed=national agency of export development
naker=tenaga kerja
nakerwan=tenaga kerja wanita
naper=nama dan peristiwa
napol=narapidana politik
napza=narkotika, alkohol, psikotropika, dan zat adiktif 
narkoba=narkotika, psikotropika, dan obat terlarang
nasa=national aeronautics and space administration
nasakom=nasionalisme, agama, komunisme
nasgitel=panas, legi, dan kental
nasgor=nasi goreng
nato=naskah asli ditetapkan oleh
nato=north atlantic treaty organization
naza=narkotika, alkohol, dan zat adiktif
nco=nusantara chamber orchestra
ndto=naskah ditandatangani oleh
nefo=new emerging forces
nekolim=neokolonialisme
nekolin=neokolonialisme
nem=nilai ebtanas murni
neric=natural resources information center
ngo=non government organization
ngr=ngurah
nhk=nippon hoso kyokai
ni=negara islam
nias=nederlands indische artsen school
nic=network interface card
nica=nederlands indies civil administration
nid=nomor induk dosen
nidn=nomor induk nasional
nig=nomor induk guru
nii=negara islam indonesia
nik=nomor induk kepegawaian
nim=nomor induk mahasiswa
nip=nomor induk pegawai
nird=nomor induk registrasi dosen
nirl=nomor induk registrasi lulusan
nirm=nomor induk registrasi mahasiswa
nis=nomor induk siswa
nisn=nomor induk siswa nasional
njop=nilai jual objek pajak
nkk=nippon kokan kaiska
nkkbs=norma keluarga kecil bahagia sejahtera
nkr=negara kesatuan republik indonesia
nkri=negara kesatuan republik indonesia
nm=nanometer
nmh=nederlands handel maatschappij
nn.=nona
no.=nomor
nonpri=nonpribumi
nopol=nomor polisi
noppen=nomor pokok penduduk
npk=nitrogen phosphat kalium
npsn=nomor pokok sekolah nasional
npwp=nomor pokok wajib pajak
nrc=netherland red cross
nri=negara republik indonesia
nrii=negara republik islam indonesia
nrp=narapidana
nrp=nomor registrasi pokok
nsa=national security agency
nta=negara tuhan aceh
ntb=nusa tenggara barat
ntcr=nikah, talak, cerai, dan rujuk
ntt=nusa tenggara timur
nu=nahdatul ulama
nusra=nusatenggara
nusrabar=nusatenggara barat
nusrateng=nusatenggara tengah
nusratim=nusatenggara timur
nusteng=nusatenggara tengah
nustengbar=nusatenggara barat
nustengtim=nusatenggara timur
nv=naamlaze vennotschap
nw=nahdlatul wathan
ny.=nyonya
o=otomat
oana=organization of asian news agencies
oas=organization of american states
oau=organization of africans unity
oc=organizing committee
odha=orang dengan hiv / aids
odmil=oditur militer
odmilti=oditur militer tinggi
oecd=organization for economic cooperation and development
oecf=overseas economic cooperation fund
oem=original equipment manufacturer
ohp=overhead projector
oic=organization of islamic conference
ok=okay
okb=orang kaya baru
oki=organisasi konferensi islam
okm=orang kaya mendadak
okp=organisasi kemasyarakatan pemuda
oku=ogan komering ulu
omg=oh my god!
omiba=obyek militer baturaja
onh=ongkos naik haji
op cit.=opere citato
op. cit.=opere citato
opbf=orient pacific boxing federation
opec=organization of petroleum exporting countries
opm=organisasi papua merdeka
opp=organisasi peserta pemilu
opsi=organisasi pekerja seluruh indonesia
opstib=operasi tertib
opsus=operasi khusus
opt=operasi pasar terbuka
optuh=operasi patuh
orari=organisasi radio amatir republik indonesia
orba=orde baru
org=orang
organda=organisasi angkatan darat
orhiba=olahraga hidup baru
ori=oeang republik indonesia
orkes=olahraga dan kesehatan
orla=orde lama
ormas=organisasi massa
orpadnas=orientasi kewaspadaan nasional
orpol=organisasi politik
orsinalmas=organisasi profesi / fungsional dan kemasyarakatan
orsos=organisasi sosial
ortala=organisasi tata laksana
ortu=orang tua
osis=organisasi siswa intrasekolah
ospek=orientasi studi dan pengenalan kampus
osza=orang-orang suci zaman akhir
ot=organisasi terlarang
otb=organisasi tanpa bentuk
otda=otonomi daerah
otk=orang tidak dikenal
otsus=otonomi khusus
ottl=organisasi tanpa tujuan laba
owl=operasi warna lindung
p lima=perut, pakaian, perumahan, pergaulan, dan pengetahuan
p.a.=per annum
p.c.=pour condoleance
p.f.=pour feliciter
p.f.v.=pour faire visite
p.m.=post meridiem
p.p.=pulang pergi
p.r.=pour remercier
p=pagina
p2kp=program penanggulangan kemiskinan di perkotaan
p3ad=pusat pendidikan perwira angkatan darat
p3dt=proyek peningkatan pembangunan desa tertinggal
p3gb=pusat pengembangan pendidikan guru bahasa
p3k=pertolongan pertama pada kecelakaan
p3m=pppm
p4=pedoman penghayatan dan pengamalan pancasila
p4d=panitia penyelesaian perselisihan perburuhan daerah
pa=pascal
pa=penasihat akademis
paban=perwira pembantu
pabbsi=persatuan angkat besi dan berat seluruh indonesia
pabum=panas bumi
pacad=perwira cadangan
padi=partai aliansi demokrat indonesia
padnas=kewaspadaan nasional
pah=panitia ad hoc
paham=pusat advokasi dan hak asasi manusia
pahe=paket hemat
pai=persatuan anggrek indonesia
pair=pusat aplikasi isotop dan radiasi
pakdes=paket desember
pakersa=panitia kerja sama kebahasaan
pakes=perwira kesehatan
pakjan=paket januari
pakno=paket november
paksi=persatuan akupunkturis seluruh indonesia
pakto=paket oktober
pal=phase alternation line
palaksa=perwira pelaksana
palkon=kepala kontol
palma=pengetahuan alam dan matematika
palwa=penjualan dan penyewaan
pam=perusahaan air minum
pama=perwira pertama
pamad=polisi militer angkatan darat
pamen=perwira menengah
pan=partai amanat nasional
pandi=pengelola nama domain internet indonesia
pandratari=pantomin, drama, dan tari
pangab=panglima angkatan bersenjata
pangad=panglima angkatan darat
pangal=panglima angkatan laut
pangamarbar=panglima armada barat
pangamartim=panglima armada timur
pangau=panglima angkatan udara
pangbes=panglima besar
pangdam=panglima daerah militer
panggar=panitia anggaran
pangkep=pangkajene kepulauan
pangkolakops=panglima komando pelaksanaan operasi
pangkoopsau=panglima komando operasi angkatan udara
pangkopkamtib=panglima komando pemulihan keamanan dan ketertiban
pangkopkamtibda=panglima komando pemulihan keamanan dan ketertiban daerah
pangkorps brimob=panglima korps brigade mobil
pangkostranas=panglima komando strategi nasional
pangkowasmar=panglima komando kawasan maratim
pangkowil=panglima komando wilayah
pangkowilhan=panglima komando wilayah pertahanan
pangkowilu=panglima komando wilayah udara
panglaksus=panglima pelaksanaan khusus
pangpas=panglima pasukan
pangter=panglima teritorial
pangti=panglima tertinggi
panja=panitia kerja
panjatap=panitia kerja tetap
pann=pengembangan armada niaga nasional
pansus=panitia khusus pantap panitia tetap
pantap=panitia tetap
pantarlih=panitia pemutakhiran data pemilih
pantarlih=panitia pendaftaran pemilih
pantura=pantai utara
panwaslak=panitia pengawas pelaksana
panwaslakda=panitia pengawas pelaksana daerah
panwaslakpus=panitia pengawas pelaksana pusat
panwaslu=panitia pengawas pemilu
pap=polska agencia prasowa
papi=pedoman akuntasi perbankan indonesia
papmi=perhimpunan ahli perancang mode indonesia
papsi=perhimpunan ahli perpustakaan seluruh indonesia
para=pasukan parasut
parako=para komando
paraku=pasukan rakyat kalimantan utara
parfi=persatuan artis film indonesia
pari=partai rakyat indonesia
parkindo=partai kristen indonesia
parmi=partai aliansi rakyat miskin indonesia
parpol=partai politik
partai golkar=partai golongan karya
parti=partai tionghoa indonesia
pas=pelita air service
pas=perwira staf
pasgab=pasukan gabungan
pasgat=pasukan gerak cepat
pasi=persatuan atletik seluruh indonesia
pasi=perwira seksi
pasis=perwira siswa
paskhas=pasukan khas
paskhasau=pasukan khas angkatan udara
paskibraka=pasukan pengibar bendera pusaka
paslon=pasangan calon
pasmi=perhimpunan asembler dan manufakturer sepeda motor dan skuter indonesia
pasopati=paduan solusi pelayanan teknologi informasi
paspal=ilmu pasti dan pengetahuan alam
paspampres=pasukan pengaman presiden
pasu=perwira satf umum
pasut=pasangnaik, pasangsurut
pasutri=pasangan suami istri
paswalpres=pasukan pengawal presiden
pat=pokok acuan tugas
pata=pacific area travel association
patal=pabrik pemintalan
patam=perwira utama
patas=cepat dan terbatas
pater=perwira teritorial
pati=perhimpunan ahli teknik indonesia
pati=perwira tinggi
patur=perwira instruktur
pay=partai abul yatama
pazi=perwira zeni
pb=pinjaman berjangka
pba=pajak bangsa asing
pbb=perserikatan bangsa-bangsa
pbdr=pajak atas bunga, dividen, dan royalti
pbh=pengurus besar harian
pbhi=perhimpunan bantuan hukum dan hak asasi manusia indonesia
pbi=persatuan boling indonesia
pbksi=persatuan bola keranjang seluruh indonesia
pbm=proses belajar mengajar
pbn=partai buruh nasional
pbsi=persatuan bulu tangkis seluruh indonesia
pbti=partai bhineka tunggal ika
pbtii=partai bhinneka tunggal ika indonesia
pbvsi=persatuan bola voli seluruh indonesia
pc=personal computer
pcb=printed circuit board
pcd=partai cinta damai
pci=peripheral component interconnect
pcpp=persatuan cendekiawan pembangunan pancasila
pd=pada
pd=perang dunia
pdam=perusahaan daerah air minum
pdb=produk domestik bruto
pdbi=pusat data bisnis indonesia
pdg=peraturan dinas garnisun
pdgi=persatuan dokter gigi indonesia
pdgmi=perhimpunan dokter gizi medik indonesia
pdh=pakaian dinas harian
pdi perjuangan=partai demokrasi indonesia
pdi=partai demokrasi indonesia
pdii=pusat dokumentasi ilmiah indonesia
pdip=partai demokrasi indonesia perjuangan
pdk=partai demokrat katolik
pdkb=partai demokrasi kasih bangsa
pdkp=partai demokrasi kasih bangsa
pdl=pakaian dinas lapangan
pdn=perusahaan dagang negara
pdr=partai daulat rakyat
pdri=pemerintah darurat republik indonesia
pds=penguasa darurat sipil
pdt=peraturan disiplin tentara
pdu=pakaian dinas upacara
pdub=pakaian dinas upacara besar
pecun=perek culun
pede=percaya diri
pefindo=pemeringkat efek indonesia
pekuper=pelaksana kuasa perang
pelaju=petik, olah dan jual
pelatda=pemusatan latihan daerah
pelatnas=pemusatan latihan nasional
pelda=pembantu letnan dua
pelindo=pelabuhan indonesia
pelita=pembangunan lima tahun
pelnas=pelarayan niaga swasta
pelni=pelayanan nasional indonesia
pelti=persatuan lawn tenis indonesia
peltu=pembantu letnan satu
pembesrev=pemimpin besar revolusi
pemda=pemerintah daerah
pemilu=pemilihan umum
pemilu=pemilihan umum
pemkot=pemerintah kota
pemprov=pemerintah provinsi
pemred=pemimpin redaksi
pemui=perhimpunan ekspedisi muatan udara indonesia
pen=internasional association of poets, playwrights, editors, and novelists
penad=penerangan angkatan darat
penal=penerangan angkatan laut
penau=penerangan angkatan udara
penggolekmah=pengusaha golongan ekonomi lemah
penjas=pendidikan jasmani
penmas=pendidikan masyarakat
penmot=penerangan dan motivasi
penpres=penetapan presiden
pentab=pendahuluan tahun ajaran baru
pepabri=persatuan purnawirawan angkatan bersenjata republik indonesia
peradah=perhimpunan pemuda hindu indonesia
peradin=persatuan advokat indonesia
perbakin=persatuan penembak indonesia
perbanas=perhimpunan bank swasta nasional
perbasasi=persatuan baseball dan softball seluruh indonesia
perbasi=persatuan bola basket seluruh indonesia
perbawaslu=peraturan badan pengawas pemilu
perbiki=persatuan bioskop keliling indonesia
percasi=persatuan catur seluruh indonesia
percasis=perkenalan calon siswa
perda=peraturan daerah
perdoksi=perhimpunan dokter spesialis dan kelamin
perek=perempuan eksperimen 'wanita tuna susila'
perfini=persatuan film nasional indonesia
perhapi=perhimpunan ahli pertambangan indonesia
perhepi=perhimpunan ekonomi pertanian indonesia
perhutani=perusahaan hutan negara indonesia
perjan=perusahaan jawatan
perjuta=perjuangan bersenjata
perkemi=persatuan kempo indonesia
perki=peraturan komisi informasi
permata=pertemuan melalui telepon anda
permendagri=peraturan menteri dalam negeri
permenkes=peraturan menteri kesehatan
permenpen=peraturan menteri penerangan
permesta=perjuangan semesta
permias=persatuan mahasiswa indonesia di amerika serikat
pernika=perang elektronika
perpamsi=persatuan perusahaan air minum di indonesia
perpani=persatuan panahan indonesia
perpobin=persatuan power boating indonesia
perpres=peraturan presiden
perpu=peraturan pengganti undangundang
persagi=persatuan ahli-ahli gizi indonesia
persahi=persatuan sarjana hukum indonesia
persani=persatuan senam indonesia
persatwi=persatuan tenaga wanita indonesia
persebaya=persatuan sepak bola surabaya
persema=persatuan sepak bola malang
perseman=persatuan sepak bola manokwari
persero=perusahaan perseroan
persetasi=persatuan sepak takraw seluruh indonesia
persib=persatuan sepak bola indonesia bandung
persiba=persatuan sepak bola indonesia balikpapan
persija=persatuan sepak bola indonesia jakarta
persikabo=persatuan sepak bola kabupaten bogor
persikota=persatuan sepak bola kota tanggerang
persipura=persatuan sepak bola indonesia jayapura
persis=persatuan islam
persit=persatuan istri tentara
persita=persatuan sepak bola indonesia tangerang
persiwa=persatuan sepak bola indonesia wamena
persma=persatuan sepak bola manado
pertamina=persatuan perusahaan pertambangan minyak dan gas bumi nasional
pertani=pertanian negara indonesia
pertasikencana=pertanian, koperasi, dan keluarga berencana
pertina=persatuan tinju amatir indonesia
perum=perusahan umum
perumka=perusahaan umum kereta api
perumnas=perumahan nasional
perumpel=perusahaan umum pelabuhan
perumtel=perusahaan umum telekomunikasi
peruri=percetakan uang republik indonesia
perwari=persatuan wanita republik indonesia
pesti=persatuan soft tenis indonesia
peta=pembela tanah air
petrus=penembak misterius
pfn=perusahaan film nasional
pg=pabrik gula
pga=pendidikan guru agama
pgaa=pendidikan guru agama atas
pgbk=pendidikan guru berdasarkan kompetensi
pgi=persekutan gereja-gereja indonesia
pgkp=pendidikan guru kejuruan pertanian
pgn=perusahaan gas negara
pgps=peraturan gaji pokok pegawai negeri sipil
pgri=persatuan guru republik indonesia
pgsd=pendidikan guru sekolah dasar
pgsi=persatuan gulat seluruh indonesia
pgsla=pendidikan guru sekolah lanjutan atas
pgslp=pendidikan guru lanjutan pertama
pgsmta=pendidikan guru sekolah menengah tingkat atas
pgsmtp=pendidikan guru sekolah menengah tingkat pertama
pgt=pasukan gerak cepat
ph.d.=philosophiae doctor
ph=akta pengakuan hutang
phdi=parisada hindu dharma indonesia
phi=panitia haji indonesia
phil.=philosophiae
philindo=philippinesindonesia
phk=pemutusan hubungan kerja
php=perselisihan hasil pemilihan
phpa=perlindungan hutan dan pelestarian alam
phpu=perselisihan hasil pemiliham umum
phri=perhimpunan hotel dan restoran indonesia
phsi=persatuan hoki seluruh indonesia
pib=partai indonesia baru
pid=partai islam demokrat
pidsus=pidana khusus
pidum=pidana umum
pifa=portugalindonesia friendship association
pii=persatuan insinyur indonesia
pijar=pusat informasi jaringan aksi untuk reformasi indonesia
pik=perkampungan industri kecil
piki=persatuan intelegensi kristen indonesia
pil=pria idaman lain
pilar=partai pilihan rakyat
pileg=pemilu legislatif
pilkada=pemilihan kepala daerah
pilkada=pemilihan kepala daerah
pilkades=pemilihan kepala desa
pilpres=pemilu presiden
pimpro=pemimpin proyek
pin=pusat informasi nasional
pindad=perindustrian angkatan darat
pinlak=pemimpin pelaksana
pipki=partai ikatan pendukung kemerdekaan indonesia
pipli=pusat informasi dan pengelolaan lingkungan hidup indonesia
pipm=pusat informasi pasar modal
pipws=proyek industri pengembangan wilayah sungai
pir=perkebunan inti rakyat
pisgor=pisang goreng
pixel=picture element
pjk=penyakit jantung koroner
pjka=perusahaan jawatan kereta api
pjr=patroli jalan raya
pjs.=pejabat sementara
pjsi=persatuan judo seluruh indonesia
pk=paardekracht
pk=partai keadilan
pkb=partai kebangkitan bangsa
pkbi=perkumpulan keluarga berencana indonesia
pkchi=perserikatan khong chiao hwee indonesia
pkd=partai katolik demokrat
pkg=pusat kerja guru
pki=partai komunis indonesia
pkk=pembinaan kesejahteraan keluarga
pkl=penyuluh kesehatan lapangan
pklh=pendidikan kependudukan lingkungan hidup
pkm=partai kebangsaan merdeka
pkmi=persatuan kaum masehi indonesia
pkni=partai kristen nasional indonesia
pkp=partai keadilan dan persatuan
pkpa=pusat kajian dan perlindungan anak
pkpb=partai karya peduli bangsa
pkpi=partai keadilan dan persatuan indonesia
pkpn=pusat koperasi pegawai negeri
pkpu=peraturan kpu
pkr=partai kedaulatan rakyat
pks=partai keadilan sejahtera
pkt=pengembangan kawasan terpadu
pku=pemeliharaan kesejahteraan umat
pkw=panti keterampilan wanita
pkwa=pusat kajian wilayah amerika
pl=praktik lapangan
plasma=pengembangan lahan dan sumber daya alam
plh.=pelaksana harian
plh=pelestarian lingkungan hidup
plm=perahu layar motor
pln=perusahaan listrik negara
plo=palestine liberation organization
plta=pembangkit listrik tenaga air
pltd=pembangkit listrik tenaga diesel
pltg=pusat listrik tenaga gas
pltgu=proyek listrik tenaga gas dan uap
pltn=pembangkit listrik tenaga nuklir
pltpb=pembangkit listrik tenaga panas bumi
plts=pembangkit listrik tenaga surya
pltu=pembangkit listrik tenaga uap
pm=polisi militer
pma=penanaman modal asing
pmb=partai masyumi baru
pmdk=penelusuran minat dan kemampuan
pmdn=penanaman modal dalam negeri
pmg=pusat meteorologi dan geofisika
pmi=palang merah indonesia
pmii=pergerakan mahasiswa islam indonesia
pmkgr=partai musyawarah kekeluargaan gotong royong
pmkri=perhimpunan mahasiswa katolik republik indonesia
pmks=penyandang masalah kesejahteraan sosial
pmp=pendidikan moral pancasila
pmpd=partai mahasiswa pro demokrasi
pmpi=partai muda pembangunan indonesia
pmptk=peningkatan mutu pendidikan dan tenaga kependidikan
pmr=palang merah remaja
pmrb=partai musyawarah rakyat banyak
pms=penyakit menular seksual
pmu=project management unit
pn=perusahaan negara
pna=philipines news agency
pnb=penerbangan
pnbi=partai nasional bangsa indonesia
pnd=partai nasional demokrat
png=papua nugini
pni=partai nasioanal indonesia
pnpm=program nasional pemberdayaan masyarakat
pnri=percetakan negara republik indonesia
pns=pegawai negeri sipil
pnu=partai nahdlatul ummat
po box=post office box
po=petunjuk operasional
pobsi=persatuan olahraga biliar seluruh indonesia
podsi=persatuan olahraga dayung seluruh indonesia
pogi=perkumpulan obstetri dan ginekologi indonesia
pokja=kelompok kerja
polantas=polisi lalu lintas
polda=kepolisian daerah
polek=polisi ekonomi
poleksosbudhankam=politik, ekonomi, sosial, budaya, pertahanan dan keamanan
poleksosbudmil=politik, ekonomi, sosial, budaya, dan militer
polhankam=politik, pertahanan dan keamanan
polhankam=politik, pertahanan, dan keamanan
polhutter=polisi hutan teritorial
polkam=politik dan keamanan
polmas=polewali mamasa
polpar=polisi pariwisata
polres=kepolisian resort
polresta=kepolisian resort kota
polri=kepolisian republik indonesia
polsek=kepolisian sektor
polsekta=kepolisian sektor kota
polsoskam=politik, sosial, dan keamanan
polstra=politik strategi
polstranas=politik strategi nasional
polsus=polisi khusus
polsuska=polisi khusus kereta api
polsustan=polisi khusus kehutanan
poltabes=kepolisian kota besar
poltas=polisi lalu lintas
polwan=polisi wanita
polwil=kepolisi wilayah
polwil=kepolisian wilayah
polwiltabes=kepolisian wilayah kota besar
pom=pengawasan obat dan makanan
pomabri=polisi militer angkatan bersenjata republik indonesia
pomad=polisi militer angkatan darat
pomal=polisi militer angkatan laut
pomau=polisi militer angkatan udara
pomg=persatuan orang tua murid dan guru
pon=pekan olahraga nasional
ponpes=pondok pesantren
ponsel=telepon seluler
poperi=perhimpunan organisasi pengacara indonesia
popnas=pekan olahraga nasional
popsi=pekan olahraga pelajar seluruh indonesia
por=pekan olahraga
porda=pekan olahraga daerah
pordasi=persatuan olahraga berkuda seluruh indonesia
porlasi=persatuan olahraga layar seluruh indonesia
porpi=persatuan olahraga pernapasan indonesia
porserosi=persatuan olahraga sepatu roda seluruh indonesia
posel=pos elektronik
posindo=pos indonesia
posma=pekan orientasi studi mahasiswa
possi=persatuan olahraga selam seluruh indonesia
postel=pos dan telekomunikasi
posyandu=pos pelayanan terpadu 
potm=persatuan orang tua murid
pp=peraturan pemerintah
ppa=perlindungan dan pengawetan alam
ppak=pelaksanaan pembelian aset kredit
ppap=penyisihan penghapusan aktiva produktif
ppatk=pusat pencatatan dan analisis transaksi keuangan
ppb=part per billion
ppb=psikologi pendidikan dan bimbingan
ppbi=persatuan pergerakan buruh indonesia
ppd=pajak pendapatan
ppd=panitia pemilihan daerah
ppdp=petugas pemutakhiran data pemilih
ppdskm=program penanggulangan dampak sosial krisis moneter
ppei=pendidikan dan pelatihan ekspor indonesia
ppfi=persatuan produsen film negara
pph=pajak penghasilan
pph=pembinaan perambah hutan
pphm=partai politik islam indonesia masyumi
ppi=persatuan perusahaan periklanan indonesia
ppid=pejabat pengelola informasi dan dokumentasi
ppip=perhimpunan persahabatan indonesia portugal
ppk=panitia pemilihan kecamatan
ppk=program pengembangan kecamatan
ppka=pemimpin perjalanan kereta api
ppki=panitia persiapan kemerdekaan indonesia
ppkkr=proyek pengembangan kebun karet rakyat
ppkpb=pedoman penyusunan kebijakan perkreditan bank
ppl=proyek pengembangan lingkungan
pplh=pengawasan pembangunan dan lingkungan hidup
ppln=panitia pemilihan luar neger
ppm=part per milion
ppm=peraturan penghormatan militer
ppmj=perhimpunan manajemen mutu indonesia
ppmki=perhimpunan penggemar mobil kuno indonesia
ppn.=pajak pendapatan
ppn=pajak penjualan
ppn=pajak pertambahan nilai
ppnbm=pajak penjualan atas barangbarang mewah
ppni=persatuan perawatan nasional indonesia
ppo=pajak pendapatan perseorangan
ppot=pusat penelitian obat tradisional
ppp=partai persatuan pembangunan
pppad=pusat pendidikan perwira angkatan darat
pppdt=proyek peningkatan pembangunan desa tertinggal
pppgb=pusat pengembangan pendidikan guru bahasa
pppi=persatuan perusahaan periklanan indonesia
pppk=pertolongan pertama pada kecelakaan
pppm=p3m
pppp=pedoman penghayatan dan pengamalan pancasila
ppppd=panitia penyelesaian perselisihan perburuhan daerah
ppq=part per quadrilion
ppr=partai pilihan rakyat
pprm=pasukan penindak rusuh massa
pps=panitia pemungutan suara
pps=panitia pemungutan suara
ppsg=persatuan pelajar sekolah guru
ppsi=prosedur pengembangan sistem instruksional
ppsk=pusat pengkajian strategi dan kebijakan
ppsp=proyek perintis sekolah pembangunan
ppt=part per trilion
ppt=pinjaman promes tetap
ppti=perkumpulan pemberantasan tuberkulosis indonesia
pptk=pusat pelaporan dan analisis transaksi keuangan
pptm=pusat pengembangan teknologi mineral
pptv=part per trilion by volume
ppw lipi=pusat penelitian politik dan kewilayahan lipi
pr=pekerjaan rumah
pra=participatory rural appraisal
prada=prajurit dua
praka=prajurit kepala
prambors=prambanan, mendut, borobudur, dan sekitarnya
pramuka=praja muda karana
prasarlub=prasekolah dan sekolah dasar luar biasa
pratangkas=prajurit tangkas
pratar=prajurit taruna
pratu=prajurit satu
prb=partai rakyat bersatu
prd=partai rakyat demokrat
presdir=presiden direktur
pri=partai rakyat indonesia
priagung=pria agung
prj=pekan raya jakarta
prk=pinjaman rekening koran
prnh=pernah
pro=profesional
prof.=profesor
prokasih=proyek kali bersih
prolita=program lima tahun
prona=program nasional agraria
pronas=produksi nasional
propam=profesi dan pengamanan
propeda=program pembangunan daerah
propenas=program pembangunan nasional
prosea=plant resources of south-east asia
protap=prosedur tetap
protem=pro tempore
prpcn=panti rehabilitasi penyandang cacat netra
prri=pemerintah revolusioner republik indonesia
prsi=persatuan renang seluruh indonesia
prssni=persatuan radio siaran swasta nasioanal indonesia
ps=power steering
psak=pernyataan standar akuntansi keuangan
psasi=persatuan ski air seluruh indonesia
psb=pusat sumber belajar
psc=production sharing contract
psdh=provisi sumber daya hutan
psh=pakaian sipil harian
psi.=psikologi
psi=partai sosialis indonesia
psii=partai syarikat islam indonesia
psim=persatuan sepak bola indonesia mataram
psis=persatuan sepak bola indonesia semarang
psk=pekerja seks komersial
psm=persatuan sepak bola makassar
psms=persatuan sepak bola medan dan sekitarnya
psp=persatuan sepak bola padang
pspb=pendidikan sejarah perjuangan bangsa
pspi=pusat studi properti indonesia
pspsi=partai solidaritas pekerja seluruh indonesia
psrsi=persatuan squash racket seluruh indonesia
pssb=program seleksi siswa berprestasi
pssi=persatuan sepak bola seluruh indonesia
psu=pemungutan suara ulang
psu=power supply unit
psuni=partai solidaritas uni nasional indonesia
psv=publik service vehicle
psw.=pesawat
pt=perseroan terbatas
ptdi=perguruan tinggi dakwah islam
ptik=perguruan tinggi ilmu kepolisian
ptiq=perguruan tinggi ilmu alquran
ptkp=pendapatan tidak kena pajak
ptl=pajak tidak langsung
ptmsi=persatuan tenis meja seluruh indonesia
ptn=perguruan tinggi negeri
pto=pajak tontonan
pto=please turn over
ptp=penduduk tanpa perkembangan
ptpn=perseroan terbatas perkebunan nusantara
ptps=pengawas tps
ptri=perwakilan tetap republik indonesia
pts=perguruan tinggi swasta
ptt=pos, telegrap dan telepon
pttun=pengadilan tinggi tata usaha negara
ptun=pengadilan tata usaha negara
pu=pekerjaan umum
puab=pasar uang antarbank
pud=peraturan urusan dalam
pudek=pembantu dekan
pudi=partai uni demokrasi indonesia
pueyd=pedoman umum ejaan bahasa indonesia yang disempurnakan
pui=persatuan umat islam
puil=peraturan umum instalasi listrik
pujagalana=pusat jajanan segala ana
pujakekal=putra jawa kelahiran / keturunan kalimantan
pujakesuma=putra jawa kelahiran / keturunan sumatra
pujasera=pusat jajan serba ada
puket=pembantu ketua
puljut=puluhan juta
pumi=partai umat muslimin indonesia
pungli=pungutan liar
pungsa=pungutan paksa
puod=pemerintahan umum dan otonomi daerah
pupi=pedoman umum pembentukan istilah
pupn=panitia urusan piutang negara
purek=pembantu rektor
purel=public relations
purnantara=purnawirawan antara
purnatak=purna + atak
pus=pusat
pusarpedal=pusat sarana pengendalian dampak lingkungan
pusba=pusat bahasa, depdiknas
pusbadhi=pusat dan pengabdi hukum indonesia
pusbindiklat=pusat pembinaan pendidikan dan pelatihan
pusbintal=pusat pembinaan mental
puscadnas=pusat cadangan nasional
pusdalopbang=pusat pengendalian operasi pembangunan
pusdiklat=pusat pendidikan dan pelatihan
pusdiklatpur=pusat pendidikan dan pelatihan pertempuran
pusdikmar=pusat pendidikan dan pelatihan marinir
pusdikpassus=pusat pendidikan dan pelatihan pasukan khusus
pusdiksandiad=pusat pendidikan dan pelatihan persandian angkatan darat
pusdikzi=pusat pendidikan zeni
pusintel=pusat intelijen
pusjarah abri=pusat sejarah abri
puskesmas=pusat kesehatan masyarakat
puskopau=pusat koperasi angkatan udara
puskud=pusat koperasi unit desa
puskur=pusat kurikulum
puslitbang=pusat penelitian dan pengembangan
puspen=pusat penerangan
puspenmas=pusat penerangan masyarakat
puspitek=pusat penelitian ilmu pengetahuan dan teknologi
pusri=pupuk sriwijaya
pusroh=pusat rohani
pustekom=pusat teknologi komunikasi
pustu=puskesmas pembantu
pv=personeel verzorger / verzorgster
pvc=polyvinyl chloride
pvmbg=pusat vulkanologi dan mitigasi bencana geologi
pwc=price waterhouse coopers
pwi=persatuan wartawan indonesia
pwri=persatuan wredatama republik indonesia
pym=paduka yang mulia
q.e.=quod est
q.q.=qualitate qua
q.v.=quod vide
qantas=queensland and northern territories air services
qc=quick count
qs=qur
r & d=reseach and development
r.a.=raden adjeng
r.ay.=raden ayu
r.m.=raden mas
r.p.m.=revolutions per minute
r.p.s.=revolutions sper second
r.r.=raden roro
r/=recipe
r/k=rekening
r=reaumur
racon=radar beacon
radar=radio detecting and ranging
raker=rapat kerja
rakerda=rapat kerja daerah
rakerdasus=rapat kerja daerah khusus
rakerkornas=rapat kerja dan koordinasi nasional
rakerlog=rapat kerja logistik
rakerna=rapat kerja paripurna
rakernas=rapat kerja nasional
rakernis=rapat kerja teknis
rakertas=rapat kerja terbatas
rakor=rapat koordinasi
rakorbang=rapat koordinasi pembangunan
ram=random access memory
ranmor=kendaraan bermotor
ranpur=kendaraan tempur
rantap=rancangan ketetapan
rantis=kendaraan taktis
rantus=rancangan keputusan
rapbd=rancangan anggaran pendapatan dan belanja daerah
rapbn=rancangan anggaran pendapatan dan belanja negara
rapi=radio antar-penduduk indonesia
rapim=rapat pimpinan
raskin=rakyat miskin
rat=rapat anggota tahunan
ratih=rakyat terlatih
rbg=rechtsreglement buitengewesten
rc=real count
rcp=rural credit programme
rcti=rajawali citra televisi indonesia
rdg=radiogram
rdip=rumah detensi imigrasi pusat
rdram=rambus dynamic random access memory
rds=reglemen daerah seberang
red.=redaksi
ref.=referensi
reg.=register
rehab=rehabilitasi
rei=real estate indonesia
rekonfu=reorganisasi, konsolidasi, dan fungsionalisasi
renop=rencana operasi
renstra=rencana strategi
renstras=rencana strategis
repelita=rencana pembangunan lima tahun
repeta=rencana pembangunan tahunan
resintel=reserse dan intelijen
resko=resor kota
reskrim=reserse kriminal
resmob=reserse mobil
resopim=revolusi, sosialisme 
restik=reserse narkotik
restik=reserse narkotika
resum=reserse umum
rfp=request for proposal
rgb=red green blue
rh factor=rhesus factor
rhs.=rahasia
ri=republik indonesia
rib=reglemen indonesia yang diperbarui
rin=resimen induk
rip=requiescat in pace
ris=republik indonesia serikat
risteknas=riset dan teknologi nasional
rkakl=rencana kerja dan anggaran-kementerian dan lembaga
rkask=rencana kerja dan anggaran-satuan kerja
rkat=rencana kerja anggaran tahunan
rkdk=rekening khusus dana kampanye
rkl=rencana kendali lingkungan
rm=ringgit malaysia
rmh=rumah
rms=republik maluku selatan
rna=ribose nucleic acid
rp=rupiah
rpa=republik persatuan arab
rph=rumah potong hewan
rpi=republik persatuan indonesia
rpkad=resimen para komando angkatan darat
rpl=rencana pemantauan lingkungan
rpm=revolutions per minute
rpp=rancangan peraturan pemerintah
rps=revolutions per second
rr.=raden roro
rra=rapid rural appraisal
rrc=republik rakyat cinta
rri=radio republik indonesia
rs=rumah sakit
rsab=rumah sakit anak dan bersalin
rsad=rumah sakit angkatan darat
rsal=rumah sakit angkatan laut
rsau=rumah sakit angkatan udara
rsb=rumah sakit bersalin
rscm=rumah sakit cipto mangunkusumo
rsh=rumah sakit hewan
rsi=rumah sakit islam
rsko=rumah sakit ketergantungan obat
rspad=rumah sakit pusat angkatan darat
rss=rumah sangat sederhana
rsu=rumah sakit umum
rsud=rumah sakit umum daerah
rsup=rumah sakit umum pusat
rsvp=r pondez s'il vous pla t
rt=rukun tetangga
rtf=rich text format
rtm=rumah tahanan militer
rubt=ruang udara bertekanan tinggi
rudal=peluru kendali
ruko=rumah toko
rups=rapat umum pemegang saham
rusi=republic of the united states of indonesia
rusun=rumah susun
rusunawa=rumah susun sewa
rutan=rumah tahanan
rutr=rencana umum tata ruang
ruu=rancangan undang-undang
ruud=rancangan undang-undang darurat
rw=rukun keluarga
s.ag.=sarjana agama
s.d.=sampai dengan
s.e.=sarjana ekonomi
s.h.=sarjana hukum
s.hut.=sarjana kehutanan
s.ip.=sarjana ilmu politik
s.k.m.=sarjana kesehatan masyarakat
s.ked.=sarjana kedokteran
s.kedg.=sarjana kedokteran gigi
s.kedh.=sarjana kedokteran hewan
s.kg.=sarjana kedokteran gigi
s.kh.=sarjana kedokteran hewan
s.km.=sarjana kesehatan masyarakat
s.kom.=sarjana komunikasi
s.m.=sarjana muda
s.p.=sarjana pendidikan
s.pd.=sarjana pendidikan
s.pi.=sarjana pertanian
s.pol.=sarjana iimu politik
s.psi.=sarjana psikologi
s.pt.=sarjana peternakan
s.s.=sarjana sastra
s.si.=sarjana sains
s.sn.=sarjana seni
s.sos.=sarjana ilmu sosial
s.t.=sarjana teknik
s.tekp.=sarjana teknologi pertanian
s.th.=sarjana theologi
s.tp.=sarjana teknologi pertanian
s.v.=sub voce atau sub verbo
s.v.p.=s'il vous plait
s=small
s1=sarjana
s-1=strata 1
s2=master
s-2=strata 2
s3=doktor
s-3=strata 3
sabhara=samapta bhayangkara
sabuga=sasana budaya ganesha
sae=society of automotive engineers
safkar=singapore armed forces kartika
sai=sistem akuntansi instansi
sajam=senjata tajam
saka=satuan karya
saker=satuan kerja
salome=satu lobang untuk ram
salt=strategic arms limition talks
samijaga=sarana air minum dan jamban keluarga
samsat=sistem administrasi manunggal satu atap
san=storage area network
sana=syrian arab news agency
sandek=pesan pendek
sanlat=pesantren kilat
sap=satuan acara perkuliahan
sapa=south african press agency
sar=search and rescue
sara=suku, agama, ras, dan antargolongan
sarusun=saruan rumah susun
sas=struktural analitis sintesis
sasdaya=sastra dan budaya
sate=sehat, aman, tertib, dan elok
satgas=satuan tugas
satgasus=satuan tugas khusus
satker=satuan kerja
satkorlak=satuan koordinator pelaksana
satlinma=satuan lintas masyarakat
satpam=satuan pengamanan
satpel=satuan pelajaran
satpolantas=kasatuan polisi lalu lintas
satpur=satuan tempur
saw.=salllallahu alaihi wassalam
sbb.=sebagai berikut
sbg.=sebagai
sbh=sebuah
sbi=sekolah bertaraf internasional
sbk=surat berharga komersial
sbkri=surat bukti kewarganegaraan republik indonesia
sblm=sebelum
sbn=surat berharga negara
sbpoa=surat bukti pelaporan orang asing
sbpu=surat berharga pasar uang
sbsi=serikat buruh sejahtera indonesia
sby=susilo bambang yudhoyono
scbd=sudirman center for business development
sctv=surya citra televisi
sd=sekolah dasar
sda=sumber daya alam
sdg=sedang
sdh=sudah
sdkt=sedikit
sdlb=sekolah dasar luar biasa
sdm=sumber daya manusia
sdr=special drawing rights
sdsb=sumbangan dermawan sosial berhadiah
se=sertifikat ekspor
seameo=southeast asian ministers of education organization
seanwfz=southeast asia nuclear weapons free zone
seato=southeast asian treaty oganization
sec=securities and exchange commission
secaba=sekolah calon bintara
secapa=sekolah perwira
secatam=sekolah calon tamtama
sek=sekretaris
sekda=sekretaris daerah
sekjen=sekretaris jenderal
sekkab=sekretaris kabinet
sekkel=sekretaris kelurahan
sekko=sekretaris kota
sekmil=sekretaris militer
sekneg=sekretaris negara
sekot=sekretaris kotif
sekota=sekretaris kota
sekpri=sekretaris pribadi
sekwilda=sekretaris wilayah daerah
sekwilko=sekretaris wilayah kota
sekwilmat=sekretaris wilayah kecamatan
selape=seleksi dan pelatihan pengemudi
seleknas=seleksi nasional
selmis=selection mini shop
sema=senat mahasiswa
sembako=sembilan bahan pokok
semdal=studi evaluasi mengenai dampak lingkungan
semiloka=seminar dan lokakarya
senawangi=sekretariat nasional pewayangan indonesia
sendratari=seni drama tari
sendratasik=seni, drama, tari, dan musik
senpi=senjata api
sepada=sekiolah pompinan administrasi dasar
sepadia=sekolah pimpinan administrasi tingkat madia
sepala=sekolah pimpinan administrasi lanjutan
sepatu=separuh tua
sepawamil=sekolah perwira wajib militer
serda=sersan dua
serdapol=sersan dua polisi
serka=sersan kepala
serkapol=sersan kepala polisi
serma=sersan mayor
sermapol=sersan mayor polisi
serse=reserse
sertar=sersan taruna
sertijab=serah terima jabatan
sertu=sersan satu
sertupol=sersan satu polisi
ses=sekretaris
sesdalopbang=sekretaris pengendalian operasi pembangunan
sesdit=sekretaris direktorat
seskab=sekretaris kabinet
sesko=sekolah staf dan komando
seskoabri=sekolah staf dan komando abri
seskoad=sekolah staf dan komando angkatan darat bersenjata republik indonesia
seskoal=sekolah staf dan komando angkatan laut
seskoau=sekolah staf dan komando angkatan udara
seskogab=sekolah staf dan komando gabungan
seskopol=sekolah staf dan komando kepolisian
sesmil=sekretaris militer
sesneg=sekretaris negara
sespa=sekolah staf dan pimpinan administrasi
sespimpol=sekolah staf dan pimpinan kepolisian
sespri=sekretaris pribadi
set=sekretariat
setjen=sekretariat jenderal
setkab=sekretariat kabinet
setmil=sekretariat militer
setneg=sekretariat negara
setum=sekretariat umum
sga=sekolah guru a
sgb=sekolah guru b
sgo=sekolah guru olahraga
sgp=serikat grafika pers
sgplb=sekolah guru pendidikan luar biasa
sgs=soci t  g n rale de surveillance
sgt=sangat
shg=sehingga
shgb=sertifikat hak guna bangunan
shm=sertifikat hak milik
shmasrs=sertifikat hak milik atas satuan rumah susun
shp=sampul hari pertama
shs=sang hyang seri
shu=sisa hasil usaha
si=seksi
si=sistem informasi
sia=singapore airlines
siap=sisa anggaran pembangunan
siapda=sisa anggaran pembangunan daerah
sidak=inspeksi mendadak
sifi=ikatan sarjana farmasi indonesia
sii=standar industri indonesia
sijori=singapura, johor, riau
sikon=situasi dan kondisi
sikt=sistem informasi kebudayaan terpadu
silon=sistem informasi pencalonan pemilu
sim=surat izin mengemudi
simkri=sistem iformasi manajemen kepegawaian republik indonesia
simpedes=simpanan pedesaan
sinetron=sinema elektronik
sip=surat izin praktik
sipak=siappakai
sipb=surat pemutihan izin bangunan
sipedes=siaran pedesaan
sipenmaru=seleksi penerimaan mahasiswa baru
sipora=sistem pengawasan orang asing
sippt=surat izin penunjuk penggunaan tanah
sipva=surat izin pembelian valuta asing
sirtukil=pasir, batu, kerikil
siscandu=sistem perencanaan terpadu
siskamling=sistem keamanan lingkungan
sistep=sistem tempat pembayaran
sit=surat izin terbit
sitarda=integrasi taruna wreda
siup=surat izin usaha perdagangan
siupp=surat izin usaha penerbitan pers
siwo=seksi wartawan olahraga
sj=saja
sj=societatis jesu
sk=surat keputusan
ska=surat keterangan asal
skalu=sekretariat kerja sama antara lima universitas
skapi=standar akutansi perbankan indonesia
skb=surat keputusan bersama
skbb=surat keterangan berkelakuan baik
skbdn=surat kredit berdokumen dalam negeri
skd=semi-knock-down
skephi=sekretariat kerjasama pelestarian hutan indonesia
skka=sekolah kependidikan keterampilan atas
skkl=sistem komunikasi kabel laut
skl=sekali
skmht=surat kuasa memasang hak tanggungan
skn=sistem kesehatan nasional
sko=surat keputusan otorisasi
skodam=staf komando daerah militer
skogar=staf komando garnisun
skp=surat ketetapan pajak
skpd=surat ketetapan pajak daerah
skpkb=surat ketetapan pajak kurang bayar
skpt=surat ketetapan pajak tahunan
skr=sekarang
sks=satuan kredit semester
sksd=sistem komunikasi satelit domestik
skshh=surat keterangan sah hasil hutan
sku=syarat kecakapan umum
sl=subledger
slb=sekolah luar biasa
sli=sambungan langsung internasional
sljj=sambungan langsung jarak jauh
sll=selalu
slm=selama
slt=sulit
slta=sekolah lanjutan tingkat atas
sltp=sekolah lanjutan tingkat pertama
sm=sebelum masehi
sma=ekolah menengah atas
smdt=sepeda motor dua tak
smea=sekolah menengah ekonomi atas
smet=sepeda motor empat tak
smi=serikat mahasiswa indonesia
smid=solidaritas mahasiswa indonesia untuk demokrasi
smk=sekolah menengah kejuruan
smp=sekolah menengah pertama
smpi=solidaritas masyarakat pers indonesia
sms=short message service
smta=sekolah menengah tingkat atas
smtp=sekolah menengah tingkat pertama
smu=sekolah menengah umum
sni=standar nasional indonesia
snmptn=seleksi nasional masuk perguruan tinggi negeri
snpe=soci t  nationale des poudres et des explosifs
snse=sistem neraca sosial ekonomi
sob=staat van oorlog en beleg
soho=small office home office
soksi=sentral organisasi karyawan swadiri indonesia
somaka=solidaritas mahasiswa untuk kasus aceh
sop=standard operating procedure
sos=tanda darurat internasional dalam kode
sosba=sosial dan bahasa
sosbud=sosial-budaya
sosek=sosial-ekonomi
sospol=sosial dan politik
sospol=sosial-politik
sotk=strukktur organisasi dan tata kerja
sp1=spesialis satu
sp-1=spesialis satu
sp2=spesialis dua
sp-2=spesialis dua
sp-3=surat perintah penghentian penyidikan
spa=saudi press agency
spau=sekolah penerbangan angkatan udara
spbu=setasiun pengisian bahan bakar umum
spg=sekolah pendidikan guru
spib=surat pemutihan izin bangunan
spj=surat pertanggungjawaban
spk=surat perintah kerja
splp=surat perjalanan laksana paspor
spm=surat perintah membayar
spma=sekolah pertanian menengah atas
spmb=sistem penerimaan masiswa baru
spmii=serikat pekerja metal indonesia
spn=serikat pekerja nasional
spp=sumbangan pembinaan pendidikan
sppd=surat perintah perjalanan dinas
sppn=surat permohonan pergi haji
sppt=surat pemberitahuan pajak tahunan
sppu=surat perintah pengeluaran uang
spri=staf pribadi
sprt=surat pemberitahuan retribusi terutang
sps=serikat perusahaan surat kabar
spsi=serikat pekerja seluruh indonesia
spt=surat pemberitahuan pajak
sptm=surat pemberitahuan pajak masa
sptt=surat pemberitahuan pajak tahunan
spy=supaya
sr=skala richter
sram=static random access memory
src=spanish red cross
sri=survey research indonesia
srit=sekolah republik indonesia tokyo
ss=space shuttle
ssb=single side band
sse=surabaya stock exchange
ssk.=satuan saham kolektif
ssk=satuan setingkat kompi
ssp=surat setoran pajak
st.=sutan
stagflasi=stagnasi dan inflasi
stia=sekolah tinggi ilmu administrasi
stki=surat tanda kewarganegaraan indonesia
stkip=sekolah tinggi keguruan dan ilmu pendidikan
stkj=sekolah tinggi kesenian jakarta
stl=setelah
stm=sekolah teknik menengah
stma=sekolah teknologi menengah atas
stmd=surat tanda melaporkan diri
stn=sekolah teknik negeri
stnk=surat tanda nomor kendaraan
sto=sentral telepon otomat
stod=satuan telepon otomat digital
stovia=school tot opleiding van indische artsen
stp=scientifically treated petroleum
stpdn=sekolah tinggi pemerintah dalam negeri
stranas=strategi nasional
sts=space transportation system
stsi=sekolah tinggi seni indonesia
stsrd=sekolah tinggi seni rupa dan desain
stt telkom=sekolah tinggi teknologi telekomunikasi
sttb=surat tanda tamat belajar
sttn=sekolah tinggi teknologi nasional
stts=surat tanda terima setoran
su=sidang umum
subbag=subbagian
subbid=subbidang
subud=susila budhi dharma
sucofindo=superintending company of indonesia
suik=sarana usaha industri kecil
sukernas=survei kerja nasional
sukwan=sukarelawan
sulbar=sulawesi barat
sulsel=sulawesi selatan
sulteng=sulawesi tengah
sultra=sulawesi tenggara
sulut=sulawesi utara
sumbagsel=sumatra bagian selatan
sumbagut=sumatra bagian utara
sumbar=sumatra barat
sumsel=sumatra selatan
sumteng=sumatra tengah
sumtim=sumatra timur
sumut=sumatra utara
suna=sudan national news agency
supas=survei penduduk antarsensus
supeltas=sukarelawan pengatur lalu lintas
supersemar=surat perintah sebelas maret
supm=sekolah usaha perikanan menengah
supt=superintenden
suratron=surat elektronik
suscados=kursus calon dosen
susduk=susunan kedudukan
susi=sekolah umum susastra islam
suslapa=kursus lanjutan perwira
suspala=kursus lanjutan perwira
suspimpemdagri=kursus pimpinan pemerintahan dalam negeri
susu tante=sumbangan sukarela tanpa tekanan
susu=sumbangan sukarela
sutemaja=susu, telur, madu, dan jahe
sutet=saluran udara tegangan ekstra tinggi
sutet=saluran utama tegangan tinggi
sutm=saluran udara tegangan menengah
svga=super video graphics array
sw=shortwave
swt.=shubhanallah wa taala
swt.=subhanahu wa taala
sy=saya
t.=teuku
t.t.=tukar tambah
tabanas=tabungan pembangunan nasional
tahapan=tabungan hari depan
takling=takbir keliling
tanamur=tanah abang timur
tanas=ketahanan nasional
tangir=tante girang
tannas=ketahanan nasional
tap.=ketetapan
tap=tunis afrique presse
tapelpram=tabungan pelajar dan pramuka
taperum=tabungan perumahan
taplus=tabungan plus
tapol=tahanan politik
tapteng=tapanuli tengah
tar=sebentar
tarling=gitar dan suling
tasar=kata dasar
taska=tabungan asuransi berjangka
taskin=pengentasan kemiskinan
taspen=tabungan dan asuransi pegawai negeri
tass=telegrafnoie agenstvo sovietskavo soyusa
tau=tahu
tavip=tahun viver
tb.=tubagus
tbc=tuberculosis
tc=traning center
tcd=typhus, cholera, dysentry
td=tadi
tdk=tidak
tdl=tarif dasar listrik
tdp=tanda daftar perusahaan
tdu=tanda daftar usaha
tec=thermoelectric cooler
tee=tetrachlorethylience
tefl=teaching english as foreign language
teh botol=teknokrat yang bodoh dan tolol
teib=tata ekonomi internasional baru
tekab=tim khusus antibandit
tel.=telepon
telefac=telefacsimile
telefax=telefacsimile
telex=teleprinter exchange
telkom=telekomunikasi
telmi=telat mikir
telstra=telaah strategi
telstranas=telaah strategi nasional
temus=tenaga musiman
tesl=teaching english as a second language
tesol=teaching english to speakers of other languages
teve=televisi
tft=thin film transistor
tgpf=tim gabungan pencari fakta
tgv=train   grande vitesse
th.=theologiae
th=tahun
thr=tunjangan hari raya
tht=telinga, hidung, dan tenggorok
tibmas=ketertiban masyarakat
tibum=ketertiban umum
tid=tunjangan ikatan dinas
tik=tujuan instruksional khusus
tilang=bukti pelanggaran
tim pkln=tim pinjaman komersial luar negeri
tim=taman ismail marzuki
time=tourism indonesia mart and expo
timor=teknologi industri mobil rakyat
timport=timor portges
timses=tim sukses
timsin=tim sinkronisasi
timsuis=intim suami isteri
timsus=tim khusus
timteng=timur tengah
timtim=timor timur
timum=tim umum
timus=tim perumus
tingwe=ngelinting dewe
tipa=tipus paratipus
tiu=tujuan instruksional umum
tk=taman kanak-kanak
tkb=tingkat kesehatan bank
tkhi=tim kesehatan haji indonesia
tki=tenaga kerja indonesia
tko=technical knock-out
tkp=tempat kejadian perkara
tkph=tentara khusus pengamanan hutan
tkr=tentara keamanan rakyat
tkrt=tenaga kerja rumah tangga
tkw=tenaga kerja wanita
tl=tube luminescent
tll=terlalu
tln=tambahan lembaran negara
tls=tulis
tmc=traffic management center
tmii=taman mini indonesia indah
tmmd=tni manunggal masuk desa
tmo=telegraphic money order
tmp=taman makam pahlawan
tna=thailand news agency
tngu=tunggu
tni=tentara nasional indonesia
tnt=trinitrotoluene
tnyta=ternyata
todat=tokoh adat
toe=tonnes oil equivalent
toefl=test of english as a foreign language
tofi=tim olimpiade fisika indonesia
toga=tanaman obat keluarga
togel=toto gelap
toji=moto siji
tomas=tokoh masyarakat
tonsus=peleton khusus
tor=petunjuk operasional rutin
torsar=motor besar
toserba=toko serba ada
tp=tapi
tpa=tempat buangan akhir
tpf=tim pencari fakta
tphi=tim pembimbing haji indonesia
tpht=tim pengamanan hutan terpadu
tpi= televisi pendidikan indonesia
tpihi=tim pembimbing ibadah haji indonesia
tpk=tujuan pengajaran khusus
tpnp=tentara pembebasan nasional papua
tpppp=tim penanganan dan penanggulangan perkara penyelundupan pusat
tppppd=tim penanganan dan penanggulangan perkara penyelundupan daerah
tpr=tanda pembayaran retribusi
tps=tempat pemungutan suara
tps=tempat pemungutan suara
tpt=tekstil dan produk tekstil
tpti=tebang pilih dan tanam indonesia
tpu=tempat pemakaman umum
transkim=transmigrasi permukiman
transkopemada=transmigrasi, koperasi, dan pembangunan masyarakat desa
translok=transmigrasi lokal
transnel=transmigrasi nelayan
transpamen=transmigrasi perwira menengah
transpolri=transmigrasi polisi republik indonesia
transpram=transmigrasi pramuka
transvetlok=transmigrasi veteran lokal
transwakarsa=transmigrasi swakarsa
trantib=ketenteraman dan ketertiban
trc=truth and reconciliation commission
tri=tebu rakyat intensifikasi
trikora=trikomando rakyat
trip=tentara rapublik indonesia pelajar
tripida=tri pimpinan daerah
tritura=trituntunan rakyat
tritura=trituntutan ampera
trm=terima
trs=terus
truk=tim relawan untuk kemanusiaan
tsb.=tersebut
tsb=transmigrasi swakarsa berbantuan
tsi=teknologi system informasi
tsm=transmigrasi swakarsa mandiri
tssb=tanda sumbangan sosial berhadiah
tst.=tahu sama tahu
tst=tahu sama tahu
tst=transplantasi sumsum tulang
tt=telegrafic transfer
ttd.=tertanda
ttg.=tertanggal
ttg=tentang
ttr=type-token ratio
tts=teka-teki silang
tu=tata usaha
tuk=teater utan kayu
tukmis=batuk klimis
tun=tata usaha negara
turba=turun ke bawah
turbo=keturunan botak
tursa=turun ke desa
tusar=turis nyasar
tv=televisi
tvri=televisi republik indonesia
twain=technologi without an important name
u.b.=untuk beliau
u.p.=untuk perhatian
u/b=untuk beliau
u/k=uang keluar
u/m=uang masuk
u/p=untuk perhatian
uae=united arab emirates
uaj=universitas atma jaya
ubhikta=universitas bhinneka tunggal
ucc=universal copyright convention
ud=utusan daerah
uda=universitas darma agung
udkp=unit daerah kerja pembangunan
udt=uniao democratica timorense
ufo=unidentified flying object
ugd=unit gawat darurat
ugm=universitas gadjah mada
uhamka=universitas prof. dr. hamka
uhf=ultrahigh frequency
uht=universitas hang tuah
ui=universitas indonesia
uia=universitas islam assyafi
uib=universitas indonesia baru
uii=universitas islam indonesia
uik=universitas ibnu khaldun
uim=universitas indonesia muda
uin=universitas islam negeri
uir=universitas islam riau
uisu=universitas islam sumatra utara
uit=universitas islam tribakti
uk=united kingdom
uka=universitas karo
ukaw=universitas kristen artha wacana
ukdw=universitas kristen duta wacana
ukgs=usaha kesehatan gigi sekolah
uki=universitas kristen indonesia
ukim=universitas kristen indonesia maluku
ukit=universitas kristen indonesia tomohon
ukm=usaha kecil dan menengah
ukmk=usaha kecil menengah dan koperasi
ukp=universitas kristen petra
uks=usaha kesehatan di sekolah
uksw=universitas kristen satya wacana
ul=ulangan
ulo=uji laik operasi
ultah=ulang tahun
uma=unified memory architecture
umar boksi=untung masih ada rambut, botaknya seksi
umgm=universitas mahapatih gajah mada
umi=universitas muslim indonesia
umj=universitas muhammadiyah jakarta
umk=universitas muria kudus
umno=united malay national organization
ump=upah minimum provinsi
umpc=ultra mobile personal computer
umptn=ujian masuk perguruan tinggi negeri
umr=upah minimum regional
ums=universitas muhammadiyah surakarta
un=united nations
una=uganda news agency
unaec=united nation atomic energy commission
unair=universitas airlangga
unamet=united nations assistance mission for east timor
unamet=united nations mission in east timor
unand=universitas andalas
unanti=universitas tridinanti
unas=universitas nasional
unbhara=universitas bhayangkara
unbo=universitas bogor
uncen=universitas cederawasih
unci=united nations commission for indonesia
uncnr=united nations conference on natural rubber
uncok=universitas cokroaminoto
unctad=united nations conference on trade and development
undana=universitas nusa cendana
undap=universitas dapur
undapa=universitas sunda kelapa
undar=universitas darul
undip=universitas diponegoro
undp=united nations development programme
unej=universitas negeri jember
unep=united nations environment programme
unes=universitas negeri semarang
unesco=united nations educational, scientific, and cultural organization
unfpa=united nations fund for papulation activities
unfrel=university network for free and fair elections
ungat=universitas gatot
unhair=universitas hairun
unhalu=universitas halu oleo
unhas=universitas hasanuddin
unhasy=universitas hasyim asy
unhatta=universitas bung hatta
unhcr=united nations high commissioner for refugees
unho=universitas haluoleo
unhul=universitas hulu
uni raya=universitas palangkaraya
uniat=universitas islam attahiriyah
unib=universitas bengkulu
unibang=universitas bangkalan
unibraw=universitas brawijaya
unicef=united nations international children's emergency fund
unida=universitas djuanda
unidayan=universitas dayanu
unido=united nations industrial development organization
unigha=universitas ghafur
unija=universitas indonesia jakarta
unik=universitas kediri
unika atma jaya=universitas katolik atma jaya
unika soegijapranata=universitas katolik soegijapranata
unikal=universitas pekalongan
unikapar=universitas katolik parahiyangan
unikass=universitas kiansantang siliwangi
unila=universitas lampung
unilak=universitas lancang kuning
unima=universitas mahadjaja
uninus=universitas islam nusantara
unipa=universitas paderi
unir=universitas islam riau
unis=universitas islam sjech jusuf
unisba=universitas islam bandung
unisemar=universitas sebelas maret
uniskar=universitas islam kalimantan
unisma=universitas islam malang
unismu=universitas muhammadiyah
unisula=universitas islam sultan agung
unizar=universitas islam alazhar
unj=universitas negeri jakarta
unjam=universitas jambi
unjani=universitas jenderal ahmad yani
unjaya=universitas jayakarta
unklab=universitas klabat
unkris=universitas krisnadwipayana
unlam=universitas lambang mangkurat
unm=universitas negeri makassar
unmad=universitas madura
unmer=universitas merdeka
unmirham=universitas amir hamzah
unmu=universitas muhammadiyah
unmul=universitas mulawarman
uno=united nations organization
unp=universitas negeri padang
unpad=universitas padjadjaran
unpadip=universitas pangeran diponegoro
unpak=universitas pakuan
unpal=universitas palembang
unpancas=universitas pancasila
unpar=universitas parahiyangan
unpas=universitas pasundan
unpatti=universitas pattimura
unram=universitas mataram
unri=universitas riau
unrwa=united nations relief and works agency
uns semar=universitas negeri surakarta sebelas maret
uns=universitas negeri surakarta sebelas maret
unsa=universitas sawerigading
unsc=united nation security council
unseb=universitas semarak bengkulu
unsil=universitas siliwangi
unsila=universitas pancasila
unsoed=universitas jenderal soedirman
unsrat=universitas sam ratulangi
unsri=universitas sriwijaya
unsuri=universitas sunan giri
unswagati=universitas swadaya gunung jati
unsyiah=universitas syiah kuala
untaa=united nations technical assistance administration
untad=universitas tadulako
untaet=united nations transitional administration in east timor
untaet=united nations transitional authority for east timor
untag=universitas tujuhbelas agustus
untan=universitas tanjungpura
untar=universitas tarumanagara
untea=united nations temporary executive authority
untid=universitas tidar
untim=universitas timtim
untirta=universitas tirtayasa
unud=universitas udayana
unwar=universitas warmadewa
unwiku=universitas wijaya kusuma
unwira=universitas widya mandira
unzah=universitas zainul hasan
uopb=unit operasi penanggulangan bencana
up=united press
upal=uang palsu
upancas=universitas pancasila
upaya=universitas pangerang jayakarta
upb=universitas patriot
upi=universitas pendidikan indonesia
upkg=usaha perbaikan gizi keluarga
upm=usaha pertanian menetap
upn=universitas pembangunan nasional
upp=unit pelaksana proyek
uppdn=unit pengolahan dan pemasaran dalam negeri
ups=uninterruptible power supply
upt=unit pelaksana teknis
uptd=unit pelaksana teknis daerah
upu=universal postal union
upw=urusan peranan wanita
urc=unit reaksi cepat
urdal=urusan dalam
uril=urusan moril
urkel=urusan keluarga
url=uniform resource locator
urss=uni republik sovyet sosialis
usa=united state of america
usakti=universitas trisakti
usb=universal serial bus
usdek=undangundang dasar 1945, sosialisme ala indonesia, ekonomi terpimpin, kepribadian indonesia
usg=ultrasonografi
usi=universitas simalungun
usia=united states information agency
usil=uang siluman
usindo=usaha industri indonesia
usno=united sabah national organization
ussr=union of soviet socialist republics
usu=universitas sumatra utara
ut=universitas terbuka
uti=universitas terbuka indonesia
utk=untuk
utp=unshielded twisted pair
utt=universitas timor timur
utul=ujian tertulis
uu=undang-undang
uud '45=undang-undang dasar 1945
uud=undangundang dasar 1945
uuds=undang-undang dasar sementara
uuhc=undang-undang hak cipta
uup=undang-undang perkawinan
uupa=undang-undang pokok agaria
uupm=undang-undang penanaman model
uuspn=undang-undang sistem pendidikan nasional
uvaya=universitas achmad yani
uwi=universitas wiraswasta indonesia
uwmy=universitas widya mataram
v.h.=voorhen
v.o.c.=vereenigde oostindische compagnie
v.s=vide supra
v.v.=vice versa
valas=valuta asing
vat=value-added tax
vb=vestigings bewijs
vbs=visa berdiam sementara
vcd=video compact disc
vcm=virtual channel memory
vcr=video cassette recorder
vcram=virtual channel read access memory
vd=venereal disease
vds=videodisk recorder
vdsl=very high data digital subscriber line
vdt=video display terminal
vdu=visual display unit
ver=visum et repertum
vesa=video electronics standards association
vf=video frequency
vfd=vacuum-flourescent displays
vfr=visual flight rules
vga=video graphics array
vhf=very high frequency
vietsel=vietnam selatan
vietut=vietnam utara
vip=very important person
vista=volunteers in service to america
vitas=visa tinggal terbatas
vivo=video in, video out
vkubp=visa kunjungan usaha beberapa kali perjalanan
vlb=vesa local bus
vlf=very low frequency
voa=voice of america
voc=verenigde oost indische compagnie
vol.=volume
vom=volt-ohm meter
vpn=virtual private network
vram=video random access memory
vs=versus
vtr=video tape recorder
vutw=varietas unggul tahan wereng
vvip=very very important person
vw=volkswagon
waba=wajib bayar
wadam=hawa adam
wadan=wakil komandan
wadir=wakil direktor
wadir=wakil direktur
wagub=wakil gubernur
wajar=wajib belajar
waka=wakil kepala
wakapri=wakil kepala perwakilan republik indonesia
wakas=wakil kepala staf
wala=wajib latih
walama=wajib latih mahasiswa
walawa=wajib latih masiswa
walhi=wahana lingkungan hidup indonesia
walop=wajib lapor
walubi=wali umat buddha indonesia
wamil=wajib militer
wampa=wakil menteri pertama
wams=world association of muslim scholars
wanhankamnas=dewan pertahanan keamanan nasional
wanjakti=dewan pertimbangan jabatan dan kepangkatan ad tingkat tinggi
wanra=perlawanan rakyat
wap=wireless application protocol
wapa=wajib pajak
wapam=warung pasar modal
wapangab=wakil panglima angkatan bersenjata
waperdam=wakil perdana menteri
wapres=wakil presiden
wapu=wajib pungut
wara=wanita angkatan udara
waria=wanita pria
warkop=warung kopi
warnet=warung internet
warteg=warung tegal
wartel=warung telekomunikasi
warten=warung tenda
wasantara=wawasan nusantara
wasantaranet=wawasan nusantara network
wasbang=pengawasan pembangunan
wasera=warung selera nusantara
waserda=warung serba ada
waskat=pengawasan melekat
wasmat=pengawas dan pengamat
wasnas=kewaspadaan nasional
wasrik=pengawasan dan pemeriksaan
watunas=wanita tunasusila
wba=world boxing association
wbc=world boxing commision
wbf=world boxing federation
wbu=wajib bela umum
wc=water closet
wcfsd=world commission on forests and sustainable development
wdm=wajib dinas militer
wdp=wajib daftar perusahaan
wftu=world federation of trade unions
who=world health organization
wi=wushu indonesia
wib=waktu indonesia barat
wic=women international club
wifi=wireless fidelity
wil=wanita idaman lain
wisdom=wisatawan domestik
wisman=wisatawan mancanegara
wisnu=wisatawan nusantara
wit=waktu indonesia timur
wita=waktu indonesia tengah
witel=wilayah usaha telekomunikasi
wks=wajib kerja sarjana
wkt=waktu
wlh=wahana lingkungan hidup
wna=warga negara asing
wni=warga indonesia
wo=walk-over
worm=write once read-many
wp=wajib pajak
wpi=wanita pembangunan indonesia
wput=wilayah pelayanan universal telekomunilkasi
wram=windows random access memory
wt=wireless telegragraphy
wtc=world trade center
wto=world trade organization
wts=wanita tunasusila
wtw=wilayah tujuan wisata
wvk=wetboek van koophandel
wvs=wetboek van strafrecht
wwf=world wildlife fund
www=waring wera wanua
wysiwyg=what you see is what you get
x div=ex dividend
x int=ex interest
xga=extended graphics array
xl=extra large
xms=extended memory specification
xs=extrasmall
xt=extended technology
y.l.=yang lalu
yad=yang akan datang
yamp=yayasan amal bakti muslim pancasila
yapptis=yayasan pengembangan perguruan tinggi swasta
yapusham=yayasan pusat studi hak asasi manusia
yasco=yayasan scorpio
ybs.=yang bersangkutan
yeu=yayasan emergensi unit
yg=yang
yi=yaitu
ykai=yayasan kesejahteraan anak indonesia
ykci=yayasan karya cipta indonesia
ykpk=yayasan kerukunan persaudaraan kebangsaan
yl=yang lain
ylbhi=yayasan lembaga bantuan hukum indonesia
ylki=yayasan lembaga konsumen indonesia
ylli=yayasan laut lestari indonesia
ymca=young men's christian association
yme=yang maha esa
ymj=yang menjalankan jabatan
yon=batalion
yonang=batalyon angkatan
yonangmor=batalyon angkatan bermotor
yonarhanudse=batalyon artileri pertahanan udara sedang
yonarmed=batalyon artileri medan
yonbekal=batalyon perbekalan peralatan
yonbekang=batalyon perbekalan dan angkutan
yongab=batalyon gabungan
yonhub=batalyon perhubungan
yonif=batalyon infanteri
yonint=batalyon intendans
yonkav=batalyon kavaleri
yonkavtai=batalyon kavaleri intai
yonkavtank=batalyon kavaleri tank
yonkes=batalyon kesehatan
yonkomlek=batalyon komunikasi elektronika
yonlinud=batalyon lintas udara
yonmar=batalyon mariner
yonpal=batalyon peralatan
yonparafib=batalyon parasut amfibi
yonpasrat=batalyon pasukan pendarat
yonpur=batalion tempur
yonpur=batalyon tempur
yonranratfib=batalyon kendaraan pendarat amfibi
yontaifibmar=batalyon intai amfibi mariner
yontankfib=batalyon tank amfibi
yonzi=batalyon zeni
yonzikon=batalyon zeni konstruksi
yonzipi=batalion zeni pionir
yonzipi=batalyon zeni pionir
yonzipur=batalyon zeni tempur
yoy=year on year
ypac=yayasan pendidikan anak cacat
ypoc=yayasan pembina olahraga cacat
yppci=yayasan pemberantasan penyakit kanker indonesia
yppki=yayasan pemberantasan penyakit kanker indonesia
ypsdmi=yayasan yayasan pengembangan sumber daya manusia
ytc.=yang tercinta
yth.=yang terhormat
ytki=yayasan tenaga kerja indonesia
ytm=youth tourist movement
yts.=yang tersayang
yts=yang tersebut
yui=yayasan ukhuwah islamiah
yumen=kayu semen
ywca=young women's christian association
za=zwavelzure ammoniak
zadat=zat padat
zair=zat cair
zana=zambia news agency
zbb=zero-based budgeting
zbnps=zona bebas senjata nuklir pasifik selatan
zee=zona ekonomi eksklusif
zeei=zona ekonomi ekslusif indonesia
zi=zeni
zialber=zeni alatalat besar
zibang=zeni bangunan
zibat=zeni jembatan
zibi=zeni amfibi
zidam=zeni daerah militer
zif=zero insertion force
zikon=zeni konstruksi
zils=zona industri lhok seumawe
zip=zoning improvement
zipat=zeni gerak cepat
zipi=zeni pionir
zipon=zeni pontonir
zipur=zeni tempur
zis=zakat, infak, dan sedekah
zo=zero option
zopfan=zone of peace, freedom, and neutrality
zoz=zie ommezijde
zpg=zero population growth
zpia=zone penangkapan ikan australia
zv=zoomed video